年月日［西暦］,地区,町丁目,世帯数,人口男［人］,人口女［人］,人口合計［人］
20190101,芝地区総合支所管内,芝一丁目,1300,976,1039,2015
20190101,芝地区総合支所管内,芝二丁目,2203,1642,1878,3520
20190101,芝地区総合支所管内,芝三丁目,2237,1712,1902,3614
20190101,芝地区総合支所管内,芝四丁目,1417,1089,1204,2293
20190101,芝地区総合支所管内,芝五丁目,1943,1154,1639,2793
20190101,芝地区総合支所管内,海岸一丁目,1311,1060,988,2048
20190101,芝地区総合支所管内,東新橋一丁目,767,668,775,1443
20190101,芝地区総合支所管内,東新橋二丁目,385,322,222,544
20190101,芝地区総合支所管内,新橋一丁目,10,5,7,12
20190101,芝地区総合支所管内,新橋二丁目,83,55,58,113
20190101,芝地区総合支所管内,新橋三丁目,135,131,101,232
20190101,芝地区総合支所管内,新橋四丁目,346,243,218,461
20190101,芝地区総合支所管内,新橋五丁目,574,394,359,753
20190101,芝地区総合支所管内,新橋六丁目,794,557,428,985
20190101,芝地区総合支所管内,西新橋一丁目,183,149,124,273
20190101,芝地区総合支所管内,西新橋二丁目,277,214,195,409
20190101,芝地区総合支所管内,西新橋三丁目,557,363,359,722
20190101,芝地区総合支所管内,三田一丁目,2447,1983,2313,4296
20190101,芝地区総合支所管内,三田二丁目,2282,1943,2353,4296
20190101,芝地区総合支所管内,三田三丁目,1083,823,855,1678
20190101,芝地区総合支所管内,浜松町一丁目,953,792,763,1555
20190101,芝地区総合支所管内,浜松町二丁目,218,162,141,303
20190101,芝地区総合支所管内,芝大門一丁目,425,317,333,650
20190101,芝地区総合支所管内,芝大門二丁目,583,390,428,818
20190101,芝地区総合支所管内,芝公園一丁目,150,105,110,215
20190101,芝地区総合支所管内,芝公園二丁目,441,329,322,651
20190101,芝地区総合支所管内,芝公園三丁目,160,149,163,312
20190101,芝地区総合支所管内,芝公園四丁目,51,34,31,65
20190101,芝地区総合支所管内,虎ノ門一丁目,271,218,219,437
20190101,芝地区総合支所管内,虎ノ門二丁目,16,15,12,27
20190101,芝地区総合支所管内,虎ノ門三丁目,1133,894,921,1815
20190101,芝地区総合支所管内,虎ノ門四丁目,369,197,371,568
20190101,芝地区総合支所管内,虎ノ門五丁目,196,183,191,374
20190101,芝地区総合支所管内,愛宕一丁目,17,19,16,35
20190101,芝地区総合支所管内,愛宕二丁目,275,263,252,515
20190101,麻布地区総合支所管内,麻布狸穴町,345,343,362,705
20190101,麻布地区総合支所管内,麻布永坂町,108,108,125,233
20190101,麻布地区総合支所管内,南麻布一丁目,2566,1966,2295,4261
20190101,麻布地区総合支所管内,南麻布二丁目,2526,1893,2157,4050
20190101,麻布地区総合支所管内,南麻布三丁目,1727,1457,1705,3162
20190101,麻布地区総合支所管内,南麻布四丁目,1882,1604,1938,3542
20190101,麻布地区総合支所管内,南麻布五丁目,1082,974,1205,2179
20190101,麻布地区総合支所管内,元麻布一丁目,577,550,641,1191
20190101,麻布地区総合支所管内,元麻布二丁目,1018,1017,1187,2204
20190101,麻布地区総合支所管内,元麻布三丁目,997,959,934,1893
20190101,麻布地区総合支所管内,西麻布一丁目,1184,875,838,1713
20190101,麻布地区総合支所管内,西麻布二丁目,1583,1281,1360,2641
20190101,麻布地区総合支所管内,西麻布三丁目,1792,1561,1787,3348
20190101,麻布地区総合支所管内,西麻布四丁目,1824,1528,1767,3295
20190101,麻布地区総合支所管内,六本木一丁目,1273,1143,1285,2428
20190101,麻布地区総合支所管内,六本木二丁目,580,353,330,683
20190101,麻布地区総合支所管内,六本木三丁目,1941,1470,1360,2830
20190101,麻布地区総合支所管内,六本木四丁目,659,638,623,1261
20190101,麻布地区総合支所管内,六本木五丁目,1171,987,1108,2095
20190101,麻布地区総合支所管内,六本木六丁目,967,885,917,1802
20190101,麻布地区総合支所管内,六本木七丁目,1459,1079,1095,2174
20190101,麻布地区総合支所管内,麻布台一丁目,200,156,152,308
20190101,麻布地区総合支所管内,麻布台二丁目,294,241,250,491
20190101,麻布地区総合支所管内,麻布台三丁目,623,478,551,1029
20190101,麻布地区総合支所管内,麻布十番一丁目,792,585,688,1273
20190101,麻布地区総合支所管内,麻布十番二丁目,1909,1314,1473,2787
20190101,麻布地区総合支所管内,麻布十番三丁目,1195,824,891,1715
20190101,麻布地区総合支所管内,麻布十番四丁目,351,186,298,484
20190101,麻布地区総合支所管内,東麻布一丁目,1582,1057,1253,2310
20190101,麻布地区総合支所管内,東麻布二丁目,1493,1108,1169,2277
20190101,麻布地区総合支所管内,東麻布三丁目,612,395,459,854
20190101,赤坂地区総合支所管内,元赤坂一丁目,207,144,161,305
20190101,赤坂地区総合支所管内,元赤坂二丁目,168,180,140,320
20190101,赤坂地区総合支所管内,赤坂一丁目,300,300,347,647
20190101,赤坂地区総合支所管内,赤坂二丁目,2064,1502,1561,3063
20190101,赤坂地区総合支所管内,赤坂三丁目,205,146,136,282
20190101,赤坂地区総合支所管内,赤坂四丁目,1341,1132,1124,2256
20190101,赤坂地区総合支所管内,赤坂五丁目,526,402,504,906
20190101,赤坂地区総合支所管内,赤坂六丁目,2387,1876,2023,3899
20190101,赤坂地区総合支所管内,赤坂七丁目,1548,1215,1319,2534
20190101,赤坂地区総合支所管内,赤坂八丁目,1717,1431,1825,3256
20190101,赤坂地区総合支所管内,赤坂九丁目,1402,1087,1014,2101
20190101,赤坂地区総合支所管内,南青山一丁目,1394,1137,1350,2487
20190101,赤坂地区総合支所管内,南青山二丁目,1217,1052,1173,2225
20190101,赤坂地区総合支所管内,南青山三丁目,681,536,664,1200
20190101,赤坂地区総合支所管内,南青山四丁目,1665,1543,1782,3325
20190101,赤坂地区総合支所管内,南青山五丁目,732,648,768,1416
20190101,赤坂地区総合支所管内,南青山六丁目,1038,850,1004,1854
20190101,赤坂地区総合支所管内,南青山七丁目,1191,1102,1343,2445
20190101,赤坂地区総合支所管内,北青山一丁目,769,615,915,1530
20190101,赤坂地区総合支所管内,北青山二丁目,300,244,293,537
20190101,赤坂地区総合支所管内,北青山三丁目,416,274,400,674
20190101,高輪地区総合支所管内,三田四丁目,2001,1615,1973,3588
20190101,高輪地区総合支所管内,三田五丁目,3282,2597,3287,5884
20190101,高輪地区総合支所管内,高輪一丁目,3894,3059,3940,6999
20190101,高輪地区総合支所管内,高輪二丁目,3718,2993,3619,6612
20190101,高輪地区総合支所管内,高輪三丁目,2537,2200,2548,4748
20190101,高輪地区総合支所管内,高輪四丁目,2335,2068,2230,4298
20190101,高輪地区総合支所管内,白金一丁目,2598,1927,2490,4417
20190101,高輪地区総合支所管内,白金二丁目,1282,1175,1456,2631
20190101,高輪地区総合支所管内,白金三丁目,2390,1832,2180,4012
20190101,高輪地区総合支所管内,白金四丁目,790,674,855,1529
20190101,高輪地区総合支所管内,白金五丁目,1063,757,930,1687
20190101,高輪地区総合支所管内,白金六丁目,1991,1690,2044,3734
20190101,高輪地区総合支所管内,白金台一丁目,486,459,572,1031
20190101,高輪地区総合支所管内,白金台二丁目,1518,1254,1548,2802
20190101,高輪地区総合支所管内,白金台三丁目,1932,1722,2184,3906
20190101,高輪地区総合支所管内,白金台四丁目,1193,947,1175,2122
20190101,高輪地区総合支所管内,白金台五丁目,1033,807,1043,1850
20190101,芝浦港南地区総合支所管内,芝浦一丁目,1841,1667,1593,3260
20190101,芝浦港南地区総合支所管内,芝浦二丁目,2203,1713,1885,3598
20190101,芝浦港南地区総合支所管内,芝浦三丁目,1230,973,1070,2043
20190101,芝浦港南地区総合支所管内,芝浦四丁目,7969,8074,8410,16484
20190101,芝浦港南地区総合支所管内,海岸二丁目,493,442,429,871
20190101,芝浦港南地区総合支所管内,海岸三丁目,2493,2031,1626,3657
20190101,芝浦港南地区総合支所管内,港南一丁目,115,105,95,200
20190101,芝浦港南地区総合支所管内,港南二丁目,1322,1238,1354,2592
20190101,芝浦港南地区総合支所管内,港南三丁目,3149,3196,3452,6648
20190101,芝浦港南地区総合支所管内,港南四丁目,4982,5112,5651,10763
20190101,芝浦港南地区総合支所管内,港南五丁目,323,307,223,530
20190101,芝浦港南地区総合支所管内,台場一丁目,2072,2228,2417,4645
20190101,芝浦港南地区総合支所管内,台場二丁目,458,483,482,965
20190201,芝地区総合支所管内,芝一丁目,1293,969,1034,2003
20190201,芝地区総合支所管内,芝二丁目,2226,1647,1885,3532
20190201,芝地区総合支所管内,芝三丁目,2229,1709,1903,3612
20190201,芝地区総合支所管内,芝四丁目,1408,1081,1213,2294
20190201,芝地区総合支所管内,芝五丁目,1952,1159,1645,2804
20190201,芝地区総合支所管内,海岸一丁目,1310,1053,991,2044
20190201,芝地区総合支所管内,東新橋一丁目,771,669,780,1449
20190201,芝地区総合支所管内,東新橋二丁目,385,323,223,546
20190201,芝地区総合支所管内,新橋一丁目,10,5,7,12
20190201,芝地区総合支所管内,新橋二丁目,83,56,57,113
20190201,芝地区総合支所管内,新橋三丁目,132,127,101,228
20190201,芝地区総合支所管内,新橋四丁目,350,245,219,464
20190201,芝地区総合支所管内,新橋五丁目,580,399,356,755
20190201,芝地区総合支所管内,新橋六丁目,787,557,420,977
20190201,芝地区総合支所管内,西新橋一丁目,184,149,126,275
20190201,芝地区総合支所管内,西新橋二丁目,276,213,192,405
20190201,芝地区総合支所管内,西新橋三丁目,562,370,357,727
20190201,芝地区総合支所管内,三田一丁目,2436,1971,2317,4288
20190201,芝地区総合支所管内,三田二丁目,2280,1944,2355,4299
20190201,芝地区総合支所管内,三田三丁目,1085,823,855,1678
20190201,芝地区総合支所管内,浜松町一丁目,959,799,761,1560
20190201,芝地区総合支所管内,浜松町二丁目,222,165,144,309
20190201,芝地区総合支所管内,芝大門一丁目,423,314,331,645
20190201,芝地区総合支所管内,芝大門二丁目,579,391,424,815
20190201,芝地区総合支所管内,芝公園一丁目,152,108,113,221
20190201,芝地区総合支所管内,芝公園二丁目,435,328,315,643
20190201,芝地区総合支所管内,芝公園三丁目,159,149,162,311
20190201,芝地区総合支所管内,芝公園四丁目,50,34,30,64
20190201,芝地区総合支所管内,虎ノ門一丁目,274,219,221,440
20190201,芝地区総合支所管内,虎ノ門二丁目,16,15,12,27
20190201,芝地区総合支所管内,虎ノ門三丁目,1131,893,918,1811
20190201,芝地区総合支所管内,虎ノ門四丁目,368,198,371,569
20190201,芝地区総合支所管内,虎ノ門五丁目,194,181,190,371
20190201,芝地区総合支所管内,愛宕一丁目,17,19,15,34
20190201,芝地区総合支所管内,愛宕二丁目,279,270,253,523
20190201,麻布地区総合支所管内,麻布狸穴町,347,346,366,712
20190201,麻布地区総合支所管内,麻布永坂町,109,110,127,237
20190201,麻布地区総合支所管内,南麻布一丁目,2552,1964,2297,4261
20190201,麻布地区総合支所管内,南麻布二丁目,2555,1901,2182,4083
20190201,麻布地区総合支所管内,南麻布三丁目,1729,1457,1699,3156
20190201,麻布地区総合支所管内,南麻布四丁目,1904,1622,1962,3584
20190201,麻布地区総合支所管内,南麻布五丁目,1089,985,1209,2194
20190201,麻布地区総合支所管内,元麻布一丁目,579,551,643,1194
20190201,麻布地区総合支所管内,元麻布二丁目,1017,1023,1191,2214
20190201,麻布地区総合支所管内,元麻布三丁目,1000,962,939,1901
20190201,麻布地区総合支所管内,西麻布一丁目,1170,867,832,1699
20190201,麻布地区総合支所管内,西麻布二丁目,1593,1287,1373,2660
20190201,麻布地区総合支所管内,西麻布三丁目,1800,1558,1785,3343
20190201,麻布地区総合支所管内,西麻布四丁目,1836,1543,1783,3326
20190201,麻布地区総合支所管内,六本木一丁目,1277,1143,1294,2437
20190201,麻布地区総合支所管内,六本木二丁目,590,363,337,700
20190201,麻布地区総合支所管内,六本木三丁目,1954,1487,1357,2844
20190201,麻布地区総合支所管内,六本木四丁目,660,639,621,1260
20190201,麻布地区総合支所管内,六本木五丁目,1164,981,1101,2082
20190201,麻布地区総合支所管内,六本木六丁目,976,898,912,1810
20190201,麻布地区総合支所管内,六本木七丁目,1455,1073,1098,2171
20190201,麻布地区総合支所管内,麻布台一丁目,186,147,141,288
20190201,麻布地区総合支所管内,麻布台二丁目,299,247,251,498
20190201,麻布地区総合支所管内,麻布台三丁目,621,476,549,1025
20190201,麻布地区総合支所管内,麻布十番一丁目,784,582,682,1264
20190201,麻布地区総合支所管内,麻布十番二丁目,1924,1322,1492,2814
20190201,麻布地区総合支所管内,麻布十番三丁目,1196,823,898,1721
20190201,麻布地区総合支所管内,麻布十番四丁目,352,185,298,483
20190201,麻布地区総合支所管内,東麻布一丁目,1582,1053,1255,2308
20190201,麻布地区総合支所管内,東麻布二丁目,1483,1102,1169,2271
20190201,麻布地区総合支所管内,東麻布三丁目,604,392,455,847
20190201,赤坂地区総合支所管内,元赤坂一丁目,207,142,164,306
20190201,赤坂地区総合支所管内,元赤坂二丁目,169,181,140,321
20190201,赤坂地区総合支所管内,赤坂一丁目,294,299,343,642
20190201,赤坂地区総合支所管内,赤坂二丁目,2067,1513,1554,3067
20190201,赤坂地区総合支所管内,赤坂三丁目,206,146,136,282
20190201,赤坂地区総合支所管内,赤坂四丁目,1348,1134,1132,2266
20190201,赤坂地区総合支所管内,赤坂五丁目,523,401,499,900
20190201,赤坂地区総合支所管内,赤坂六丁目,2379,1867,2022,3889
20190201,赤坂地区総合支所管内,赤坂七丁目,1541,1216,1316,2532
20190201,赤坂地区総合支所管内,赤坂八丁目,1717,1430,1820,3250
20190201,赤坂地区総合支所管内,赤坂九丁目,1405,1094,1005,2099
20190201,赤坂地区総合支所管内,南青山一丁目,1396,1146,1351,2497
20190201,赤坂地区総合支所管内,南青山二丁目,1225,1067,1174,2241
20190201,赤坂地区総合支所管内,南青山三丁目,676,535,662,1197
20190201,赤坂地区総合支所管内,南青山四丁目,1680,1557,1796,3353
20190201,赤坂地区総合支所管内,南青山五丁目,725,645,766,1411
20190201,赤坂地区総合支所管内,南青山六丁目,1046,860,1015,1875
20190201,赤坂地区総合支所管内,南青山七丁目,1195,1099,1345,2444
20190201,赤坂地区総合支所管内,北青山一丁目,766,614,907,1521
20190201,赤坂地区総合支所管内,北青山二丁目,299,242,292,534
20190201,赤坂地区総合支所管内,北青山三丁目,406,272,390,662
20190201,高輪地区総合支所管内,三田四丁目,1997,1613,1972,3585
20190201,高輪地区総合支所管内,三田五丁目,3280,2610,3286,5896
20190201,高輪地区総合支所管内,高輪一丁目,3898,3074,3932,7006
20190201,高輪地区総合支所管内,高輪二丁目,3720,3002,3623,6625
20190201,高輪地区総合支所管内,高輪三丁目,2541,2204,2555,4759
20190201,高輪地区総合支所管内,高輪四丁目,2317,2047,2255,4302
20190201,高輪地区総合支所管内,白金一丁目,2591,1921,2482,4403
20190201,高輪地区総合支所管内,白金二丁目,1296,1187,1454,2641
20190201,高輪地区総合支所管内,白金三丁目,2397,1838,2181,4019
20190201,高輪地区総合支所管内,白金四丁目,792,679,854,1533
20190201,高輪地区総合支所管内,白金五丁目,1065,759,927,1686
20190201,高輪地区総合支所管内,白金六丁目,1995,1687,2054,3741
20190201,高輪地区総合支所管内,白金台一丁目,483,455,571,1026
20190201,高輪地区総合支所管内,白金台二丁目,1511,1253,1534,2787
20190201,高輪地区総合支所管内,白金台三丁目,1940,1730,2189,3919
20190201,高輪地区総合支所管内,白金台四丁目,1188,943,1179,2122
20190201,高輪地区総合支所管内,白金台五丁目,1039,813,1046,1859
20190201,芝浦港南地区総合支所管内,芝浦一丁目,1849,1683,1593,3276
20190201,芝浦港南地区総合支所管内,芝浦二丁目,2187,1711,1867,3578
20190201,芝浦港南地区総合支所管内,芝浦三丁目,1231,982,1066,2048
20190201,芝浦港南地区総合支所管内,芝浦四丁目,8060,8122,8467,16589
20190201,芝浦港南地区総合支所管内,海岸二丁目,495,449,429,878
20190201,芝浦港南地区総合支所管内,海岸三丁目,2494,2036,1631,3667
20190201,芝浦港南地区総合支所管内,港南一丁目,115,104,98,202
20190201,芝浦港南地区総合支所管内,港南二丁目,1331,1246,1363,2609
20190201,芝浦港南地区総合支所管内,港南三丁目,3144,3190,3442,6632
20190201,芝浦港南地区総合支所管内,港南四丁目,5000,5133,5662,10795
20190201,芝浦港南地区総合支所管内,港南五丁目,325,309,224,533
20190201,芝浦港南地区総合支所管内,台場一丁目,2079,2237,2426,4663
20190201,芝浦港南地区総合支所管内,台場二丁目,458,483,482,965
20190301,芝地区総合支所管内,芝一丁目,1300,975,1043,2018
20190301,芝地区総合支所管内,芝二丁目,2217,1647,1886,3533
20190301,芝地区総合支所管内,芝三丁目,2232,1714,1905,3619
20190301,芝地区総合支所管内,芝四丁目,1408,1078,1216,2294
20190301,芝地区総合支所管内,芝五丁目,1946,1157,1641,2798
20190301,芝地区総合支所管内,海岸一丁目,1295,1038,979,2017
20190301,芝地区総合支所管内,東新橋一丁目,770,667,780,1447
20190301,芝地区総合支所管内,東新橋二丁目,385,323,224,547
20190301,芝地区総合支所管内,新橋一丁目,10,5,8,13
20190301,芝地区総合支所管内,新橋二丁目,83,56,57,113
20190301,芝地区総合支所管内,新橋三丁目,131,126,101,227
20190301,芝地区総合支所管内,新橋四丁目,349,245,216,461
20190301,芝地区総合支所管内,新橋五丁目,597,407,362,769
20190301,芝地区総合支所管内,新橋六丁目,782,552,419,971
20190301,芝地区総合支所管内,西新橋一丁目,182,148,124,272
20190301,芝地区総合支所管内,西新橋二丁目,278,212,195,407
20190301,芝地区総合支所管内,西新橋三丁目,555,367,352,719
20190301,芝地区総合支所管内,三田一丁目,2437,1968,2326,4294
20190301,芝地区総合支所管内,三田二丁目,2289,1948,2363,4311
20190301,芝地区総合支所管内,三田三丁目,1077,817,851,1668
20190301,芝地区総合支所管内,浜松町一丁目,969,798,766,1564
20190301,芝地区総合支所管内,浜松町二丁目,217,164,139,303
20190301,芝地区総合支所管内,芝大門一丁目,425,316,328,644
20190301,芝地区総合支所管内,芝大門二丁目,586,401,424,825
20190301,芝地区総合支所管内,芝公園一丁目,153,107,116,223
20190301,芝地区総合支所管内,芝公園二丁目,434,329,315,644
20190301,芝地区総合支所管内,芝公園三丁目,160,151,164,315
20190301,芝地区総合支所管内,芝公園四丁目,51,35,30,65
20190301,芝地区総合支所管内,虎ノ門一丁目,278,220,223,443
20190301,芝地区総合支所管内,虎ノ門二丁目,15,14,12,26
20190301,芝地区総合支所管内,虎ノ門三丁目,1137,902,923,1825
20190301,芝地区総合支所管内,虎ノ門四丁目,368,202,371,573
20190301,芝地区総合支所管内,虎ノ門五丁目,194,180,191,371
20190301,芝地区総合支所管内,愛宕一丁目,18,21,16,37
20190301,芝地区総合支所管内,愛宕二丁目,272,261,247,508
20190301,麻布地区総合支所管内,麻布狸穴町,347,344,364,708
20190301,麻布地区総合支所管内,麻布永坂町,109,110,128,238
20190301,麻布地区総合支所管内,南麻布一丁目,2555,1960,2297,4257
20190301,麻布地区総合支所管内,南麻布二丁目,2571,1910,2193,4103
20190301,麻布地区総合支所管内,南麻布三丁目,1720,1452,1694,3146
20190301,麻布地区総合支所管内,南麻布四丁目,1909,1631,1970,3601
20190301,麻布地区総合支所管内,南麻布五丁目,1094,989,1221,2210
20190301,麻布地区総合支所管内,元麻布一丁目,577,551,646,1197
20190301,麻布地区総合支所管内,元麻布二丁目,1019,1026,1199,2225
20190301,麻布地区総合支所管内,元麻布三丁目,1000,959,948,1907
20190301,麻布地区総合支所管内,西麻布一丁目,1172,866,833,1699
20190301,麻布地区総合支所管内,西麻布二丁目,1602,1293,1383,2676
20190301,麻布地区総合支所管内,西麻布三丁目,1805,1565,1785,3350
20190301,麻布地区総合支所管内,西麻布四丁目,1834,1541,1776,3317
20190301,麻布地区総合支所管内,六本木一丁目,1288,1158,1303,2461
20190301,麻布地区総合支所管内,六本木二丁目,591,369,333,702
20190301,麻布地区総合支所管内,六本木三丁目,1956,1492,1357,2849
20190301,麻布地区総合支所管内,六本木四丁目,694,663,625,1288
20190301,麻布地区総合支所管内,六本木五丁目,1166,983,1096,2079
20190301,麻布地区総合支所管内,六本木六丁目,949,873,912,1785
20190301,麻布地区総合支所管内,六本木七丁目,1444,1066,1094,2160
20190301,麻布地区総合支所管内,麻布台一丁目,174,140,132,272
20190301,麻布地区総合支所管内,麻布台二丁目,296,249,252,501
20190301,麻布地区総合支所管内,麻布台三丁目,624,482,551,1033
20190301,麻布地区総合支所管内,麻布十番一丁目,775,578,675,1253
20190301,麻布地区総合支所管内,麻布十番二丁目,1931,1332,1497,2829
20190301,麻布地区総合支所管内,麻布十番三丁目,1201,833,893,1726
20190301,麻布地区総合支所管内,麻布十番四丁目,350,184,299,483
20190301,麻布地区総合支所管内,東麻布一丁目,1585,1047,1261,2308
20190301,麻布地区総合支所管内,東麻布二丁目,1489,1105,1173,2278
20190301,麻布地区総合支所管内,東麻布三丁目,604,393,457,850
20190301,赤坂地区総合支所管内,元赤坂一丁目,208,142,163,305
20190301,赤坂地区総合支所管内,元赤坂二丁目,171,183,136,319
20190301,赤坂地区総合支所管内,赤坂一丁目,296,300,347,647
20190301,赤坂地区総合支所管内,赤坂二丁目,2075,1524,1556,3080
20190301,赤坂地区総合支所管内,赤坂三丁目,203,143,133,276
20190301,赤坂地区総合支所管内,赤坂四丁目,1342,1121,1131,2252
20190301,赤坂地区総合支所管内,赤坂五丁目,524,402,498,900
20190301,赤坂地区総合支所管内,赤坂六丁目,2380,1871,2020,3891
20190301,赤坂地区総合支所管内,赤坂七丁目,1551,1217,1331,2548
20190301,赤坂地区総合支所管内,赤坂八丁目,1721,1436,1825,3261
20190301,赤坂地区総合支所管内,赤坂九丁目,1395,1084,997,2081
20190301,赤坂地区総合支所管内,南青山一丁目,1391,1143,1349,2492
20190301,赤坂地区総合支所管内,南青山二丁目,1231,1071,1175,2246
20190301,赤坂地区総合支所管内,南青山三丁目,673,532,659,1191
20190301,赤坂地区総合支所管内,南青山四丁目,1684,1560,1802,3362
20190301,赤坂地区総合支所管内,南青山五丁目,720,645,762,1407
20190301,赤坂地区総合支所管内,南青山六丁目,1053,864,1018,1882
20190301,赤坂地区総合支所管内,南青山七丁目,1200,1100,1350,2450
20190301,赤坂地区総合支所管内,北青山一丁目,765,613,905,1518
20190301,赤坂地区総合支所管内,北青山二丁目,302,243,296,539
20190301,赤坂地区総合支所管内,北青山三丁目,397,273,380,653
20190301,高輪地区総合支所管内,三田四丁目,1994,1606,1964,3570
20190301,高輪地区総合支所管内,三田五丁目,3280,2604,3294,5898
20190301,高輪地区総合支所管内,高輪一丁目,3885,3072,3922,6994
20190301,高輪地区総合支所管内,高輪二丁目,3720,3000,3624,6624
20190301,高輪地区総合支所管内,高輪三丁目,2541,2209,2552,4761
20190301,高輪地区総合支所管内,高輪四丁目,2320,2044,2253,4297
20190301,高輪地区総合支所管内,白金一丁目,2597,1923,2483,4406
20190301,高輪地区総合支所管内,白金二丁目,1297,1190,1454,2644
20190301,高輪地区総合支所管内,白金三丁目,2395,1830,2192,4022
20190301,高輪地区総合支所管内,白金四丁目,792,682,854,1536
20190301,高輪地区総合支所管内,白金五丁目,1069,764,927,1691
20190301,高輪地区総合支所管内,白金六丁目,2001,1685,2062,3747
20190301,高輪地区総合支所管内,白金台一丁目,480,456,570,1026
20190301,高輪地区総合支所管内,白金台二丁目,1521,1265,1547,2812
20190301,高輪地区総合支所管内,白金台三丁目,1934,1730,2186,3916
20190301,高輪地区総合支所管内,白金台四丁目,1187,947,1181,2128
20190301,高輪地区総合支所管内,白金台五丁目,1040,813,1047,1860
20190301,芝浦港南地区総合支所管内,芝浦一丁目,1849,1685,1596,3281
20190301,芝浦港南地区総合支所管内,芝浦二丁目,2185,1700,1870,3570
20190301,芝浦港南地区総合支所管内,芝浦三丁目,1232,979,1067,2046
20190301,芝浦港南地区総合支所管内,芝浦四丁目,8136,8178,8517,16695
20190301,芝浦港南地区総合支所管内,海岸二丁目,499,451,434,885
20190301,芝浦港南地区総合支所管内,海岸三丁目,2489,2045,1630,3675
20190301,芝浦港南地区総合支所管内,港南一丁目,112,99,97,196
20190301,芝浦港南地区総合支所管内,港南二丁目,1334,1248,1355,2603
20190301,芝浦港南地区総合支所管内,港南三丁目,3149,3197,3444,6641
20190301,芝浦港南地区総合支所管内,港南四丁目,4985,5117,5646,10763
20190301,芝浦港南地区総合支所管内,港南五丁目,324,309,223,532
20190301,芝浦港南地区総合支所管内,台場一丁目,2069,2235,2421,4656
20190301,芝浦港南地区総合支所管内,台場二丁目,458,479,484,963
20190401,芝地区総合支所管内,芝一丁目,1315,994,1048,2042
20190401,芝地区総合支所管内,芝二丁目,2240,1661,1891,3552
20190401,芝地区総合支所管内,芝三丁目,2258,1735,1913,3648
20190401,芝地区総合支所管内,芝四丁目,1420,1086,1218,2304
20190401,芝地区総合支所管内,芝五丁目,1941,1148,1638,2786
20190401,芝地区総合支所管内,海岸一丁目,1282,1028,976,2004
20190401,芝地区総合支所管内,東新橋一丁目,770,667,773,1440
20190401,芝地区総合支所管内,東新橋二丁目,391,327,223,550
20190401,芝地区総合支所管内,新橋一丁目,10,5,8,13
20190401,芝地区総合支所管内,新橋二丁目,79,56,53,109
20190401,芝地区総合支所管内,新橋三丁目,126,122,100,222
20190401,芝地区総合支所管内,新橋四丁目,347,236,220,456
20190401,芝地区総合支所管内,新橋五丁目,620,418,380,798
20190401,芝地区総合支所管内,新橋六丁目,791,553,424,977
20190401,芝地区総合支所管内,西新橋一丁目,183,149,122,271
20190401,芝地区総合支所管内,西新橋二丁目,273,205,188,393
20190401,芝地区総合支所管内,西新橋三丁目,616,389,407,796
20190401,芝地区総合支所管内,三田一丁目,2441,1977,2340,4317
20190401,芝地区総合支所管内,三田二丁目,2325,1966,2396,4362
20190401,芝地区総合支所管内,三田三丁目,1068,811,851,1662
20190401,芝地区総合支所管内,浜松町一丁目,994,812,787,1599
20190401,芝地区総合支所管内,浜松町二丁目,215,162,135,297
20190401,芝地区総合支所管内,芝大門一丁目,419,312,328,640
20190401,芝地区総合支所管内,芝大門二丁目,584,398,424,822
20190401,芝地区総合支所管内,芝公園一丁目,158,110,120,230
20190401,芝地区総合支所管内,芝公園二丁目,445,332,323,655
20190401,芝地区総合支所管内,芝公園三丁目,163,152,164,316
20190401,芝地区総合支所管内,芝公園四丁目,51,35,30,65
20190401,芝地区総合支所管内,虎ノ門一丁目,280,221,223,444
20190401,芝地区総合支所管内,虎ノ門二丁目,15,14,12,26
20190401,芝地区総合支所管内,虎ノ門三丁目,1142,900,922,1822
20190401,芝地区総合支所管内,虎ノ門四丁目,396,201,400,601
20190401,芝地区総合支所管内,虎ノ門五丁目,186,173,185,358
20190401,芝地区総合支所管内,愛宕一丁目,19,23,17,40
20190401,芝地区総合支所管内,愛宕二丁目,275,258,247,505
20190401,麻布地区総合支所管内,麻布狸穴町,342,341,356,697
20190401,麻布地区総合支所管内,麻布永坂町,112,113,130,243
20190401,麻布地区総合支所管内,南麻布一丁目,2572,1979,2306,4285
20190401,麻布地区総合支所管内,南麻布二丁目,2573,1900,2185,4085
20190401,麻布地区総合支所管内,南麻布三丁目,1753,1466,1726,3192
20190401,麻布地区総合支所管内,南麻布四丁目,1910,1622,1970,3592
20190401,麻布地区総合支所管内,南麻布五丁目,1091,985,1218,2203
20190401,麻布地区総合支所管内,元麻布一丁目,579,552,647,1199
20190401,麻布地区総合支所管内,元麻布二丁目,1014,1025,1190,2215
20190401,麻布地区総合支所管内,元麻布三丁目,1000,950,949,1899
20190401,麻布地区総合支所管内,西麻布一丁目,1183,870,843,1713
20190401,麻布地区総合支所管内,西麻布二丁目,1607,1292,1386,2678
20190401,麻布地区総合支所管内,西麻布三丁目,1809,1570,1783,3353
20190401,麻布地区総合支所管内,西麻布四丁目,1849,1553,1787,3340
20190401,麻布地区総合支所管内,六本木一丁目,1287,1153,1305,2458
20190401,麻布地区総合支所管内,六本木二丁目,591,362,337,699
20190401,麻布地区総合支所管内,六本木三丁目,1958,1505,1354,2859
20190401,麻布地区総合支所管内,六本木四丁目,705,680,629,1309
20190401,麻布地区総合支所管内,六本木五丁目,1176,988,1109,2097
20190401,麻布地区総合支所管内,六本木六丁目,938,866,912,1778
20190401,麻布地区総合支所管内,六本木七丁目,1439,1065,1089,2154
20190401,麻布地区総合支所管内,麻布台一丁目,169,138,126,264
20190401,麻布地区総合支所管内,麻布台二丁目,304,257,262,519
20190401,麻布地区総合支所管内,麻布台三丁目,628,484,553,1037
20190401,麻布地区総合支所管内,麻布十番一丁目,812,600,686,1286
20190401,麻布地区総合支所管内,麻布十番二丁目,1938,1324,1499,2823
20190401,麻布地区総合支所管内,麻布十番三丁目,1243,854,920,1774
20190401,麻布地区総合支所管内,麻布十番四丁目,353,185,301,486
20190401,麻布地区総合支所管内,東麻布一丁目,1602,1063,1277,2340
20190401,麻布地区総合支所管内,東麻布二丁目,1488,1106,1174,2280
20190401,麻布地区総合支所管内,東麻布三丁目,608,390,465,855
20190401,赤坂地区総合支所管内,元赤坂一丁目,213,146,165,311
20190401,赤坂地区総合支所管内,元赤坂二丁目,167,180,135,315
20190401,赤坂地区総合支所管内,赤坂一丁目,294,300,346,646
20190401,赤坂地区総合支所管内,赤坂二丁目,2084,1531,1565,3096
20190401,赤坂地区総合支所管内,赤坂三丁目,198,140,130,270
20190401,赤坂地区総合支所管内,赤坂四丁目,1338,1124,1126,2250
20190401,赤坂地区総合支所管内,赤坂五丁目,529,407,497,904
20190401,赤坂地区総合支所管内,赤坂六丁目,2413,1882,2022,3904
20190401,赤坂地区総合支所管内,赤坂七丁目,1548,1218,1323,2541
20190401,赤坂地区総合支所管内,赤坂八丁目,1720,1441,1819,3260
20190401,赤坂地区総合支所管内,赤坂九丁目,1416,1105,1006,2111
20190401,赤坂地区総合支所管内,南青山一丁目,1393,1148,1358,2506
20190401,赤坂地区総合支所管内,南青山二丁目,1241,1076,1175,2251
20190401,赤坂地区総合支所管内,南青山三丁目,667,523,652,1175
20190401,赤坂地区総合支所管内,南青山四丁目,1696,1562,1809,3371
20190401,赤坂地区総合支所管内,南青山五丁目,719,643,758,1401
20190401,赤坂地区総合支所管内,南青山六丁目,1045,855,1007,1862
20190401,赤坂地区総合支所管内,南青山七丁目,1215,1104,1360,2464
20190401,赤坂地区総合支所管内,北青山一丁目,759,607,893,1500
20190401,赤坂地区総合支所管内,北青山二丁目,303,243,297,540
20190401,赤坂地区総合支所管内,北青山三丁目,388,268,374,642
20190401,高輪地区総合支所管内,三田四丁目,2013,1630,1972,3602
20190401,高輪地区総合支所管内,三田五丁目,3298,2609,3301,5910
20190401,高輪地区総合支所管内,高輪一丁目,3908,3082,3934,7016
20190401,高輪地区総合支所管内,高輪二丁目,3742,2990,3643,6633
20190401,高輪地区総合支所管内,高輪三丁目,2550,2207,2563,4770
20190401,高輪地区総合支所管内,高輪四丁目,2365,2093,2246,4339
20190401,高輪地区総合支所管内,白金一丁目,2610,1917,2479,4396
20190401,高輪地区総合支所管内,白金二丁目,1304,1195,1443,2638
20190401,高輪地区総合支所管内,白金三丁目,2405,1836,2186,4022
20190401,高輪地区総合支所管内,白金四丁目,793,687,850,1537
20190401,高輪地区総合支所管内,白金五丁目,1086,779,932,1711
20190401,高輪地区総合支所管内,白金六丁目,1999,1672,2062,3734
20190401,高輪地区総合支所管内,白金台一丁目,482,460,570,1030
20190401,高輪地区総合支所管内,白金台二丁目,1541,1264,1571,2835
20190401,高輪地区総合支所管内,白金台三丁目,1941,1733,2191,3924
20190401,高輪地区総合支所管内,白金台四丁目,1185,931,1172,2103
20190401,高輪地区総合支所管内,白金台五丁目,1041,809,1050,1859
20190401,芝浦港南地区総合支所管内,芝浦一丁目,1852,1686,1589,3275
20190401,芝浦港南地区総合支所管内,芝浦二丁目,2219,1703,1890,3593
20190401,芝浦港南地区総合支所管内,芝浦三丁目,1238,979,1069,2048
20190401,芝浦港南地区総合支所管内,芝浦四丁目,8163,8193,8517,16710
20190401,芝浦港南地区総合支所管内,海岸二丁目,512,454,441,895
20190401,芝浦港南地区総合支所管内,海岸三丁目,2483,2047,1614,3661
20190401,芝浦港南地区総合支所管内,港南一丁目,140,118,116,234
20190401,芝浦港南地区総合支所管内,港南二丁目,1340,1248,1352,2600
20190401,芝浦港南地区総合支所管内,港南三丁目,3138,3182,3436,6618
20190401,芝浦港南地区総合支所管内,港南四丁目,4962,5091,5612,10703
20190401,芝浦港南地区総合支所管内,港南五丁目,324,307,222,529
20190401,芝浦港南地区総合支所管内,台場一丁目,2069,2233,2423,4656
20190401,芝浦港南地区総合支所管内,台場二丁目,458,477,484,961
20190501,芝地区総合支所管内,芝一丁目,1313,996,1043,2039
20190501,芝地区総合支所管内,芝二丁目,2254,1668,1901,3569
20190501,芝地区総合支所管内,芝三丁目,2270,1742,1912,3654
20190501,芝地区総合支所管内,芝四丁目,1418,1081,1213,2294
20190501,芝地区総合支所管内,芝五丁目,1967,1159,1659,2818
20190501,芝地区総合支所管内,海岸一丁目,1260,1021,963,1984
20190501,芝地区総合支所管内,東新橋一丁目,769,662,776,1438
20190501,芝地区総合支所管内,東新橋二丁目,393,328,225,553
20190501,芝地区総合支所管内,新橋一丁目,10,5,8,13
20190501,芝地区総合支所管内,新橋二丁目,77,56,51,107
20190501,芝地区総合支所管内,新橋三丁目,125,120,98,218
20190501,芝地区総合支所管内,新橋四丁目,346,236,216,452
20190501,芝地区総合支所管内,新橋五丁目,624,424,380,804
20190501,芝地区総合支所管内,新橋六丁目,787,550,425,975
20190501,芝地区総合支所管内,西新橋一丁目,186,152,122,274
20190501,芝地区総合支所管内,西新橋二丁目,274,205,187,392
20190501,芝地区総合支所管内,西新橋三丁目,646,403,425,828
20190501,芝地区総合支所管内,三田一丁目,2444,1990,2331,4321
20190501,芝地区総合支所管内,三田二丁目,2335,1965,2394,4359
20190501,芝地区総合支所管内,三田三丁目,1070,809,850,1659
20190501,芝地区総合支所管内,浜松町一丁目,1014,823,808,1631
20190501,芝地区総合支所管内,浜松町二丁目,217,165,134,299
20190501,芝地区総合支所管内,芝大門一丁目,416,312,330,642
20190501,芝地区総合支所管内,芝大門二丁目,588,400,426,826
20190501,芝地区総合支所管内,芝公園一丁目,159,111,120,231
20190501,芝地区総合支所管内,芝公園二丁目,441,332,319,651
20190501,芝地区総合支所管内,芝公園三丁目,162,151,163,314
20190501,芝地区総合支所管内,芝公園四丁目,50,35,28,63
20190501,芝地区総合支所管内,虎ノ門一丁目,280,220,225,445
20190501,芝地区総合支所管内,虎ノ門二丁目,12,12,8,20
20190501,芝地区総合支所管内,虎ノ門三丁目,1145,898,923,1821
20190501,芝地区総合支所管内,虎ノ門四丁目,392,199,397,596
20190501,芝地区総合支所管内,虎ノ門五丁目,185,171,187,358
20190501,芝地区総合支所管内,愛宕一丁目,19,23,17,40
20190501,芝地区総合支所管内,愛宕二丁目,276,258,248,506
20190501,麻布地区総合支所管内,麻布狸穴町,339,339,353,692
20190501,麻布地区総合支所管内,麻布永坂町,115,113,131,244
20190501,麻布地区総合支所管内,南麻布一丁目,2591,1981,2326,4307
20190501,麻布地区総合支所管内,南麻布二丁目,2570,1906,2183,4089
20190501,麻布地区総合支所管内,南麻布三丁目,1758,1468,1737,3205
20190501,麻布地区総合支所管内,南麻布四丁目,1906,1618,1960,3578
20190501,麻布地区総合支所管内,南麻布五丁目,1093,995,1224,2219
20190501,麻布地区総合支所管内,元麻布一丁目,582,557,648,1205
20190501,麻布地区総合支所管内,元麻布二丁目,1015,1029,1192,2221
20190501,麻布地区総合支所管内,元麻布三丁目,1011,961,958,1919
20190501,麻布地区総合支所管内,西麻布一丁目,1200,880,849,1729
20190501,麻布地区総合支所管内,西麻布二丁目,1614,1301,1386,2687
20190501,麻布地区総合支所管内,西麻布三丁目,1824,1573,1801,3374
20190501,麻布地区総合支所管内,西麻布四丁目,1839,1542,1785,3327
20190501,麻布地区総合支所管内,六本木一丁目,1286,1154,1307,2461
20190501,麻布地区総合支所管内,六本木二丁目,598,363,346,709
20190501,麻布地区総合支所管内,六本木三丁目,1959,1502,1370,2872
20190501,麻布地区総合支所管内,六本木四丁目,734,706,650,1356
20190501,麻布地区総合支所管内,六本木五丁目,1184,991,1121,2112
20190501,麻布地区総合支所管内,六本木六丁目,922,848,906,1754
20190501,麻布地区総合支所管内,六本木七丁目,1453,1080,1090,2170
20190501,麻布地区総合支所管内,麻布台一丁目,155,128,115,243
20190501,麻布地区総合支所管内,麻布台二丁目,298,251,254,505
20190501,麻布地区総合支所管内,麻布台三丁目,627,487,549,1036
20190501,麻布地区総合支所管内,麻布十番一丁目,813,606,689,1295
20190501,麻布地区総合支所管内,麻布十番二丁目,1931,1324,1488,2812
20190501,麻布地区総合支所管内,麻布十番三丁目,1257,859,926,1785
20190501,麻布地区総合支所管内,麻布十番四丁目,350,185,296,481
20190501,麻布地区総合支所管内,東麻布一丁目,1616,1068,1288,2356
20190501,麻布地区総合支所管内,東麻布二丁目,1483,1095,1178,2273
20190501,麻布地区総合支所管内,東麻布三丁目,613,398,465,863
20190501,赤坂地区総合支所管内,元赤坂一丁目,214,148,169,317
20190501,赤坂地区総合支所管内,元赤坂二丁目,173,181,140,321
20190501,赤坂地区総合支所管内,赤坂一丁目,297,303,350,653
20190501,赤坂地区総合支所管内,赤坂二丁目,2097,1543,1559,3102
20190501,赤坂地区総合支所管内,赤坂三丁目,197,143,128,271
20190501,赤坂地区総合支所管内,赤坂四丁目,1356,1138,1143,2281
20190501,赤坂地区総合支所管内,赤坂五丁目,530,407,494,901
20190501,赤坂地区総合支所管内,赤坂六丁目,2447,1898,2052,3950
20190501,赤坂地区総合支所管内,赤坂七丁目,1550,1211,1323,2534
20190501,赤坂地区総合支所管内,赤坂八丁目,1715,1430,1819,3249
20190501,赤坂地区総合支所管内,赤坂九丁目,1422,1117,1002,2119
20190501,赤坂地区総合支所管内,南青山一丁目,1415,1164,1378,2542
20190501,赤坂地区総合支所管内,南青山二丁目,1248,1085,1180,2265
20190501,赤坂地区総合支所管内,南青山三丁目,671,524,660,1184
20190501,赤坂地区総合支所管内,南青山四丁目,1694,1569,1808,3377
20190501,赤坂地区総合支所管内,南青山五丁目,727,653,762,1415
20190501,赤坂地区総合支所管内,南青山六丁目,1047,864,1004,1868
20190501,赤坂地区総合支所管内,南青山七丁目,1225,1121,1366,2487
20190501,赤坂地区総合支所管内,北青山一丁目,755,599,883,1482
20190501,赤坂地区総合支所管内,北青山二丁目,305,244,299,543
20190501,赤坂地区総合支所管内,北青山三丁目,384,265,372,637
20190501,高輪地区総合支所管内,三田四丁目,2030,1634,2001,3635
20190501,高輪地区総合支所管内,三田五丁目,3318,2631,3323,5954
20190501,高輪地区総合支所管内,高輪一丁目,3898,3085,3920,7005
20190501,高輪地区総合支所管内,高輪二丁目,3764,2997,3668,6665
20190501,高輪地区総合支所管内,高輪三丁目,2556,2202,2560,4762
20190501,高輪地区総合支所管内,高輪四丁目,2374,2098,2252,4350
20190501,高輪地区総合支所管内,白金一丁目,2613,1912,2489,4401
20190501,高輪地区総合支所管内,白金二丁目,1286,1174,1441,2615
20190501,高輪地区総合支所管内,白金三丁目,2405,1827,2203,4030
20190501,高輪地区総合支所管内,白金四丁目,794,686,853,1539
20190501,高輪地区総合支所管内,白金五丁目,1083,779,923,1702
20190501,高輪地区総合支所管内,白金六丁目,2009,1684,2079,3763
20190501,高輪地区総合支所管内,白金台一丁目,486,460,571,1031
20190501,高輪地区総合支所管内,白金台二丁目,1542,1267,1580,2847
20190501,高輪地区総合支所管内,白金台三丁目,1949,1732,2199,3931
20190501,高輪地区総合支所管内,白金台四丁目,1217,952,1193,2145
20190501,高輪地区総合支所管内,白金台五丁目,1038,805,1043,1848
20190501,芝浦港南地区総合支所管内,芝浦一丁目,1834,1678,1576,3254
20190501,芝浦港南地区総合支所管内,芝浦二丁目,2214,1702,1881,3583
20190501,芝浦港南地区総合支所管内,芝浦三丁目,1246,986,1072,2058
20190501,芝浦港南地区総合支所管内,芝浦四丁目,8173,8205,8535,16740
20190501,芝浦港南地区総合支所管内,海岸二丁目,515,459,445,904
20190501,芝浦港南地区総合支所管内,海岸三丁目,2493,2039,1625,3664
20190501,芝浦港南地区総合支所管内,港南一丁目,155,127,129,256
20190501,芝浦港南地区総合支所管内,港南二丁目,1340,1243,1347,2590
20190501,芝浦港南地区総合支所管内,港南三丁目,3126,3165,3421,6586
20190501,芝浦港南地区総合支所管内,港南四丁目,4986,5107,5634,10741
20190501,芝浦港南地区総合支所管内,港南五丁目,322,306,222,528
20190501,芝浦港南地区総合支所管内,台場一丁目,2066,2224,2409,4633
20190501,芝浦港南地区総合支所管内,台場二丁目,456,476,486,962
20190601,芝地区総合支所管内,芝一丁目,1311,994,1042,2036
20190601,芝地区総合支所管内,芝二丁目,2264,1675,1914,3589
20190601,芝地区総合支所管内,芝三丁目,2257,1734,1901,3635
20190601,芝地区総合支所管内,芝四丁目,1415,1082,1211,2293
20190601,芝地区総合支所管内,芝五丁目,1957,1158,1648,2806
20190601,芝地区総合支所管内,海岸一丁目,1226,1004,951,1955
20190601,芝地区総合支所管内,東新橋一丁目,770,663,777,1440
20190601,芝地区総合支所管内,東新橋二丁目,390,326,226,552
20190601,芝地区総合支所管内,新橋一丁目,10,5,8,13
20190601,芝地区総合支所管内,新橋二丁目,77,56,51,107
20190601,芝地区総合支所管内,新橋三丁目,122,117,97,214
20190601,芝地区総合支所管内,新橋四丁目,356,244,220,464
20190601,芝地区総合支所管内,新橋五丁目,637,431,389,820
20190601,芝地区総合支所管内,新橋六丁目,781,549,424,973
20190601,芝地区総合支所管内,西新橋一丁目,188,153,123,276
20190601,芝地区総合支所管内,西新橋二丁目,271,204,185,389
20190601,芝地区総合支所管内,西新橋三丁目,652,409,430,839
20190601,芝地区総合支所管内,三田一丁目,2436,1988,2318,4306
20190601,芝地区総合支所管内,三田二丁目,2339,1966,2394,4360
20190601,芝地区総合支所管内,三田三丁目,1078,810,862,1672
20190601,芝地区総合支所管内,浜松町一丁目,1034,839,815,1654
20190601,芝地区総合支所管内,浜松町二丁目,217,163,135,298
20190601,芝地区総合支所管内,芝大門一丁目,421,317,334,651
20190601,芝地区総合支所管内,芝大門二丁目,585,396,425,821
20190601,芝地区総合支所管内,芝公園一丁目,160,112,121,233
20190601,芝地区総合支所管内,芝公園二丁目,449,331,328,659
20190601,芝地区総合支所管内,芝公園三丁目,162,150,163,313
20190601,芝地区総合支所管内,芝公園四丁目,51,35,29,64
20190601,芝地区総合支所管内,虎ノ門一丁目,280,216,227,443
20190601,芝地区総合支所管内,虎ノ門二丁目,11,11,7,18
20190601,芝地区総合支所管内,虎ノ門三丁目,1141,895,916,1811
20190601,芝地区総合支所管内,虎ノ門四丁目,390,199,396,595
20190601,芝地区総合支所管内,虎ノ門五丁目,181,166,186,352
20190601,芝地区総合支所管内,愛宕一丁目,19,23,17,40
20190601,芝地区総合支所管内,愛宕二丁目,277,259,248,507
20190601,麻布地区総合支所管内,麻布狸穴町,338,338,350,688
20190601,麻布地区総合支所管内,麻布永坂町,115,114,132,246
20190601,麻布地区総合支所管内,南麻布一丁目,2582,1974,2319,4293
20190601,麻布地区総合支所管内,南麻布二丁目,2568,1915,2189,4104
20190601,麻布地区総合支所管内,南麻布三丁目,1756,1475,1744,3219
20190601,麻布地区総合支所管内,南麻布四丁目,1912,1629,1967,3596
20190601,麻布地区総合支所管内,南麻布五丁目,1095,995,1223,2218
20190601,麻布地区総合支所管内,元麻布一丁目,582,557,647,1204
20190601,麻布地区総合支所管内,元麻布二丁目,1013,1025,1198,2223
20190601,麻布地区総合支所管内,元麻布三丁目,1024,966,959,1925
20190601,麻布地区総合支所管内,西麻布一丁目,1200,881,853,1734
20190601,麻布地区総合支所管内,西麻布二丁目,1599,1283,1375,2658
20190601,麻布地区総合支所管内,西麻布三丁目,1830,1578,1811,3389
20190601,麻布地区総合支所管内,西麻布四丁目,1833,1542,1787,3329
20190601,麻布地区総合支所管内,六本木一丁目,1295,1168,1318,2486
20190601,麻布地区総合支所管内,六本木二丁目,606,368,350,718
20190601,麻布地区総合支所管内,六本木三丁目,1953,1507,1382,2889
20190601,麻布地区総合支所管内,六本木四丁目,733,701,651,1352
20190601,麻布地区総合支所管内,六本木五丁目,1196,995,1128,2123
20190601,麻布地区総合支所管内,六本木六丁目,917,843,908,1751
20190601,麻布地区総合支所管内,六本木七丁目,1446,1079,1086,2165
20190601,麻布地区総合支所管内,麻布台一丁目,152,127,112,239
20190601,麻布地区総合支所管内,麻布台二丁目,303,257,253,510
20190601,麻布地区総合支所管内,麻布台三丁目,630,488,553,1041
20190601,麻布地区総合支所管内,麻布十番一丁目,809,606,681,1287
20190601,麻布地区総合支所管内,麻布十番二丁目,1933,1325,1484,2809
20190601,麻布地区総合支所管内,麻布十番三丁目,1265,871,928,1799
20190601,麻布地区総合支所管内,麻布十番四丁目,353,188,297,485
20190601,麻布地区総合支所管内,東麻布一丁目,1622,1074,1296,2370
20190601,麻布地区総合支所管内,東麻布二丁目,1490,1105,1178,2283
20190601,麻布地区総合支所管内,東麻布三丁目,613,399,465,864
20190601,赤坂地区総合支所管内,元赤坂一丁目,214,149,170,319
20190601,赤坂地区総合支所管内,元赤坂二丁目,177,181,143,324
20190601,赤坂地区総合支所管内,赤坂一丁目,297,307,351,658
20190601,赤坂地区総合支所管内,赤坂二丁目,2095,1538,1554,3092
20190601,赤坂地区総合支所管内,赤坂三丁目,194,142,126,268
20190601,赤坂地区総合支所管内,赤坂四丁目,1354,1133,1136,2269
20190601,赤坂地区総合支所管内,赤坂五丁目,530,405,494,899
20190601,赤坂地区総合支所管内,赤坂六丁目,2465,1915,2065,3980
20190601,赤坂地区総合支所管内,赤坂七丁目,1548,1219,1318,2537
20190601,赤坂地区総合支所管内,赤坂八丁目,1724,1442,1825,3267
20190601,赤坂地区総合支所管内,赤坂九丁目,1434,1127,1005,2132
20190601,赤坂地区総合支所管内,南青山一丁目,1426,1172,1387,2559
20190601,赤坂地区総合支所管内,南青山二丁目,1252,1085,1179,2264
20190601,赤坂地区総合支所管内,南青山三丁目,672,526,659,1185
20190601,赤坂地区総合支所管内,南青山四丁目,1703,1570,1821,3391
20190601,赤坂地区総合支所管内,南青山五丁目,728,655,764,1419
20190601,赤坂地区総合支所管内,南青山六丁目,1042,864,1000,1864
20190601,赤坂地区総合支所管内,南青山七丁目,1221,1115,1357,2472
20190601,赤坂地区総合支所管内,北青山一丁目,752,597,876,1473
20190601,赤坂地区総合支所管内,北青山二丁目,303,241,297,538
20190601,赤坂地区総合支所管内,北青山三丁目,384,268,373,641
20190601,高輪地区総合支所管内,三田四丁目,2022,1638,1999,3637
20190601,高輪地区総合支所管内,三田五丁目,3322,2632,3332,5964
20190601,高輪地区総合支所管内,高輪一丁目,3901,3086,3925,7011
20190601,高輪地区総合支所管内,高輪二丁目,3759,2986,3669,6655
20190601,高輪地区総合支所管内,高輪三丁目,2562,2211,2559,4770
20190601,高輪地区総合支所管内,高輪四丁目,2362,2077,2256,4333
20190601,高輪地区総合支所管内,白金一丁目,2600,1902,2476,4378
20190601,高輪地区総合支所管内,白金二丁目,1286,1181,1438,2619
20190601,高輪地区総合支所管内,白金三丁目,2404,1826,2216,4042
20190601,高輪地区総合支所管内,白金四丁目,798,692,858,1550
20190601,高輪地区総合支所管内,白金五丁目,1089,782,926,1708
20190601,高輪地区総合支所管内,白金六丁目,2012,1687,2084,3771
20190601,高輪地区総合支所管内,白金台一丁目,488,459,573,1032
20190601,高輪地区総合支所管内,白金台二丁目,1545,1269,1586,2855
20190601,高輪地区総合支所管内,白金台三丁目,1949,1736,2206,3942
20190601,高輪地区総合支所管内,白金台四丁目,1219,949,1204,2153
20190601,高輪地区総合支所管内,白金台五丁目,1053,813,1063,1876
20190601,芝浦港南地区総合支所管内,芝浦一丁目,1847,1683,1591,3274
20190601,芝浦港南地区総合支所管内,芝浦二丁目,2211,1704,1884,3588
20190601,芝浦港南地区総合支所管内,芝浦三丁目,1248,990,1079,2069
20190601,芝浦港南地区総合支所管内,芝浦四丁目,8183,8228,8549,16777
20190601,芝浦港南地区総合支所管内,海岸二丁目,518,459,449,908
20190601,芝浦港南地区総合支所管内,海岸三丁目,2495,2033,1629,3662
20190601,芝浦港南地区総合支所管内,港南一丁目,174,140,141,281
20190601,芝浦港南地区総合支所管内,港南二丁目,1349,1258,1342,2600
20190601,芝浦港南地区総合支所管内,港南三丁目,3125,3158,3421,6579
20190601,芝浦港南地区総合支所管内,港南四丁目,4995,5126,5624,10750
20190601,芝浦港南地区総合支所管内,港南五丁目,320,305,222,527
20190601,芝浦港南地区総合支所管内,台場一丁目,2064,2230,2416,4646
20190601,芝浦港南地区総合支所管内,台場二丁目,455,476,484,960
20190701,芝地区総合支所管内,芝一丁目,1314,997,1046,2043
20190701,芝地区総合支所管内,芝二丁目,2276,1679,1923,3602
20190701,芝地区総合支所管内,芝三丁目,2254,1735,1897,3632
20190701,芝地区総合支所管内,芝四丁目,1423,1089,1214,2303
20190701,芝地区総合支所管内,芝五丁目,1949,1150,1643,2793
20190701,芝地区総合支所管内,海岸一丁目,1177,963,920,1883
20190701,芝地区総合支所管内,東新橋一丁目,768,655,774,1429
20190701,芝地区総合支所管内,東新橋二丁目,388,325,223,548
20190701,芝地区総合支所管内,新橋一丁目,10,5,8,13
20190701,芝地区総合支所管内,新橋二丁目,77,56,51,107
20190701,芝地区総合支所管内,新橋三丁目,121,115,98,213
20190701,芝地区総合支所管内,新橋四丁目,361,245,224,469
20190701,芝地区総合支所管内,新橋五丁目,646,435,395,830
20190701,芝地区総合支所管内,新橋六丁目,779,550,424,974
20190701,芝地区総合支所管内,西新橋一丁目,187,152,121,273
20190701,芝地区総合支所管内,西新橋二丁目,266,194,181,375
20190701,芝地区総合支所管内,西新橋三丁目,655,412,432,844
20190701,芝地区総合支所管内,三田一丁目,2435,1991,2316,4307
20190701,芝地区総合支所管内,三田二丁目,2346,1973,2405,4378
20190701,芝地区総合支所管内,三田三丁目,1073,805,863,1668
20190701,芝地区総合支所管内,浜松町一丁目,1180,996,949,1945
20190701,芝地区総合支所管内,浜松町二丁目,215,162,135,297
20190701,芝地区総合支所管内,芝大門一丁目,419,317,328,645
20190701,芝地区総合支所管内,芝大門二丁目,587,398,423,821
20190701,芝地区総合支所管内,芝公園一丁目,160,113,119,232
20190701,芝地区総合支所管内,芝公園二丁目,454,332,331,663
20190701,芝地区総合支所管内,芝公園三丁目,161,147,160,307
20190701,芝地区総合支所管内,芝公園四丁目,49,34,28,62
20190701,芝地区総合支所管内,虎ノ門一丁目,282,217,228,445
20190701,芝地区総合支所管内,虎ノ門二丁目,9,8,7,15
20190701,芝地区総合支所管内,虎ノ門三丁目,1136,889,906,1795
20190701,芝地区総合支所管内,虎ノ門四丁目,388,198,395,593
20190701,芝地区総合支所管内,虎ノ門五丁目,174,160,176,336
20190701,芝地区総合支所管内,愛宕一丁目,19,24,20,44
20190701,芝地区総合支所管内,愛宕二丁目,284,266,257,523
20190701,麻布地区総合支所管内,麻布狸穴町,344,341,356,697
20190701,麻布地区総合支所管内,麻布永坂町,114,112,131,243
20190701,麻布地区総合支所管内,南麻布一丁目,2567,1966,2310,4276
20190701,麻布地区総合支所管内,南麻布二丁目,2564,1911,2182,4093
20190701,麻布地区総合支所管内,南麻布三丁目,1749,1468,1736,3204
20190701,麻布地区総合支所管内,南麻布四丁目,1907,1617,1957,3574
20190701,麻布地区総合支所管内,南麻布五丁目,1096,995,1228,2223
20190701,麻布地区総合支所管内,元麻布一丁目,581,560,644,1204
20190701,麻布地区総合支所管内,元麻布二丁目,1003,1016,1181,2197
20190701,麻布地区総合支所管内,元麻布三丁目,1017,945,935,1880
20190701,麻布地区総合支所管内,西麻布一丁目,1188,875,850,1725
20190701,麻布地区総合支所管内,西麻布二丁目,1608,1296,1380,2676
20190701,麻布地区総合支所管内,西麻布三丁目,1820,1577,1808,3385
20190701,麻布地区総合支所管内,西麻布四丁目,1837,1542,1792,3334
20190701,麻布地区総合支所管内,六本木一丁目,1283,1151,1310,2461
20190701,麻布地区総合支所管内,六本木二丁目,610,368,354,722
20190701,麻布地区総合支所管内,六本木三丁目,1937,1497,1364,2861
20190701,麻布地区総合支所管内,六本木四丁目,726,693,653,1346
20190701,麻布地区総合支所管内,六本木五丁目,1202,1001,1129,2130
20190701,麻布地区総合支所管内,六本木六丁目,909,840,883,1723
20190701,麻布地区総合支所管内,六本木七丁目,1452,1081,1087,2168
20190701,麻布地区総合支所管内,麻布台一丁目,148,125,111,236
20190701,麻布地区総合支所管内,麻布台二丁目,303,258,253,511
20190701,麻布地区総合支所管内,麻布台三丁目,632,487,557,1044
20190701,麻布地区総合支所管内,麻布十番一丁目,806,610,678,1288
20190701,麻布地区総合支所管内,麻布十番二丁目,1946,1328,1489,2817
20190701,麻布地区総合支所管内,麻布十番三丁目,1259,868,924,1792
20190701,麻布地区総合支所管内,麻布十番四丁目,348,185,291,476
20190701,麻布地区総合支所管内,東麻布一丁目,1625,1069,1296,2365
20190701,麻布地区総合支所管内,東麻布二丁目,1481,1100,1175,2275
20190701,麻布地区総合支所管内,東麻布三丁目,612,402,461,863
20190701,赤坂地区総合支所管内,元赤坂一丁目,219,153,172,325
20190701,赤坂地区総合支所管内,元赤坂二丁目,176,181,143,324
20190701,赤坂地区総合支所管内,赤坂一丁目,294,299,340,639
20190701,赤坂地区総合支所管内,赤坂二丁目,2093,1545,1540,3085
20190701,赤坂地区総合支所管内,赤坂三丁目,194,141,125,266
20190701,赤坂地区総合支所管内,赤坂四丁目,1354,1127,1141,2268
20190701,赤坂地区総合支所管内,赤坂五丁目,529,403,496,899
20190701,赤坂地区総合支所管内,赤坂六丁目,2479,1915,2064,3979
20190701,赤坂地区総合支所管内,赤坂七丁目,1558,1229,1323,2552
20190701,赤坂地区総合支所管内,赤坂八丁目,1728,1445,1829,3274
20190701,赤坂地区総合支所管内,赤坂九丁目,1444,1140,1006,2146
20190701,赤坂地区総合支所管内,南青山一丁目,1433,1177,1395,2572
20190701,赤坂地区総合支所管内,南青山二丁目,1253,1091,1178,2269
20190701,赤坂地区総合支所管内,南青山三丁目,669,525,656,1181
20190701,赤坂地区総合支所管内,南青山四丁目,1704,1570,1822,3392
20190701,赤坂地区総合支所管内,南青山五丁目,726,649,763,1412
20190701,赤坂地区総合支所管内,南青山六丁目,1036,858,1000,1858
20190701,赤坂地区総合支所管内,南青山七丁目,1220,1117,1363,2480
20190701,赤坂地区総合支所管内,北青山一丁目,749,595,874,1469
20190701,赤坂地区総合支所管内,北青山二丁目,304,243,297,540
20190701,赤坂地区総合支所管内,北青山三丁目,381,268,369,637
20190701,高輪地区総合支所管内,三田四丁目,2016,1640,1988,3628
20190701,高輪地区総合支所管内,三田五丁目,3326,2640,3343,5983
20190701,高輪地区総合支所管内,高輪一丁目,3892,3081,3919,7000
20190701,高輪地区総合支所管内,高輪二丁目,3753,2990,3670,6660
20190701,高輪地区総合支所管内,高輪三丁目,2569,2220,2564,4784
20190701,高輪地区総合支所管内,高輪四丁目,2355,2068,2243,4311
20190701,高輪地区総合支所管内,白金一丁目,2592,1900,2473,4373
20190701,高輪地区総合支所管内,白金二丁目,1272,1169,1434,2603
20190701,高輪地区総合支所管内,白金三丁目,2395,1817,2204,4021
20190701,高輪地区総合支所管内,白金四丁目,798,689,857,1546
20190701,高輪地区総合支所管内,白金五丁目,1089,777,922,1699
20190701,高輪地区総合支所管内,白金六丁目,2013,1689,2087,3776
20190701,高輪地区総合支所管内,白金台一丁目,493,456,577,1033
20190701,高輪地区総合支所管内,白金台二丁目,1540,1263,1588,2851
20190701,高輪地区総合支所管内,白金台三丁目,1960,1742,2220,3962
20190701,高輪地区総合支所管内,白金台四丁目,1225,957,1197,2154
20190701,高輪地区総合支所管内,白金台五丁目,1051,813,1061,1874
20190701,芝浦港南地区総合支所管内,芝浦一丁目,1852,1683,1604,3287
20190701,芝浦港南地区総合支所管内,芝浦二丁目,2218,1711,1885,3596
20190701,芝浦港南地区総合支所管内,芝浦三丁目,1256,993,1088,2081
20190701,芝浦港南地区総合支所管内,芝浦四丁目,8190,8254,8565,16819
20190701,芝浦港南地区総合支所管内,海岸二丁目,519,458,448,906
20190701,芝浦港南地区総合支所管内,海岸三丁目,2501,2042,1623,3665
20190701,芝浦港南地区総合支所管内,港南一丁目,190,152,149,301
20190701,芝浦港南地区総合支所管内,港南二丁目,1368,1277,1371,2648
20190701,芝浦港南地区総合支所管内,港南三丁目,3115,3145,3419,6564
20190701,芝浦港南地区総合支所管内,港南四丁目,4996,5123,5626,10749
20190701,芝浦港南地区総合支所管内,港南五丁目,321,307,224,531
20190701,芝浦港南地区総合支所管内,台場一丁目,2063,2235,2419,4654
20190701,芝浦港南地区総合支所管内,台場二丁目,457,474,483,957
20190801,芝地区総合支所管内,芝一丁目,1309,992,1048,2040
20190801,芝地区総合支所管内,芝二丁目,2284,1687,1932,3619
20190801,芝地区総合支所管内,芝三丁目,2258,1739,1900,3639
20190801,芝地区総合支所管内,芝四丁目,1422,1089,1206,2295
20190801,芝地区総合支所管内,芝五丁目,1956,1157,1643,2800
20190801,芝地区総合支所管内,海岸一丁目,1162,959,911,1870
20190801,芝地区総合支所管内,東新橋一丁目,770,659,775,1434
20190801,芝地区総合支所管内,東新橋二丁目,393,324,227,551
20190801,芝地区総合支所管内,新橋一丁目,10,5,8,13
20190801,芝地区総合支所管内,新橋二丁目,79,57,52,109
20190801,芝地区総合支所管内,新橋三丁目,126,119,100,219
20190801,芝地区総合支所管内,新橋四丁目,364,245,227,472
20190801,芝地区総合支所管内,新橋五丁目,652,434,402,836
20190801,芝地区総合支所管内,新橋六丁目,775,545,423,968
20190801,芝地区総合支所管内,西新橋一丁目,185,150,122,272
20190801,芝地区総合支所管内,西新橋二丁目,264,194,177,371
20190801,芝地区総合支所管内,西新橋三丁目,647,405,429,834
20190801,芝地区総合支所管内,三田一丁目,2421,1973,2305,4278
20190801,芝地区総合支所管内,三田二丁目,2350,1982,2415,4397
20190801,芝地区総合支所管内,三田三丁目,1069,804,857,1661
20190801,芝地区総合支所管内,浜松町一丁目,1201,1012,969,1981
20190801,芝地区総合支所管内,浜松町二丁目,219,167,136,303
20190801,芝地区総合支所管内,芝大門一丁目,416,320,327,647
20190801,芝地区総合支所管内,芝大門二丁目,586,402,419,821
20190801,芝地区総合支所管内,芝公園一丁目,165,116,122,238
20190801,芝地区総合支所管内,芝公園二丁目,453,333,333,666
20190801,芝地区総合支所管内,芝公園三丁目,161,150,162,312
20190801,芝地区総合支所管内,芝公園四丁目,49,33,29,62
20190801,芝地区総合支所管内,虎ノ門一丁目,282,218,229,447
20190801,芝地区総合支所管内,虎ノ門二丁目,10,8,6,14
20190801,芝地区総合支所管内,虎ノ門三丁目,1133,894,905,1799
20190801,芝地区総合支所管内,虎ノ門四丁目,388,195,391,586
20190801,芝地区総合支所管内,虎ノ門五丁目,173,159,176,335
20190801,芝地区総合支所管内,愛宕一丁目,20,24,21,45
20190801,芝地区総合支所管内,愛宕二丁目,278,265,254,519
20190801,麻布地区総合支所管内,麻布狸穴町,345,342,356,698
20190801,麻布地区総合支所管内,麻布永坂町,114,111,131,242
20190801,麻布地区総合支所管内,南麻布一丁目,2565,1958,2309,4267
20190801,麻布地区総合支所管内,南麻布二丁目,2558,1913,2179,4092
20190801,麻布地区総合支所管内,南麻布三丁目,1740,1458,1724,3182
20190801,麻布地区総合支所管内,南麻布四丁目,1902,1621,1942,3563
20190801,麻布地区総合支所管内,南麻布五丁目,1094,996,1217,2213
20190801,麻布地区総合支所管内,元麻布一丁目,580,556,649,1205
20190801,麻布地区総合支所管内,元麻布二丁目,997,1015,1175,2190
20190801,麻布地区総合支所管内,元麻布三丁目,1002,931,923,1854
20190801,麻布地区総合支所管内,西麻布一丁目,1177,871,840,1711
20190801,麻布地区総合支所管内,西麻布二丁目,1629,1309,1386,2695
20190801,麻布地区総合支所管内,西麻布三丁目,1822,1564,1796,3360
20190801,麻布地区総合支所管内,西麻布四丁目,1841,1544,1801,3345
20190801,麻布地区総合支所管内,六本木一丁目,1277,1149,1305,2454
20190801,麻布地区総合支所管内,六本木二丁目,619,378,363,741
20190801,麻布地区総合支所管内,六本木三丁目,1938,1486,1356,2842
20190801,麻布地区総合支所管内,六本木四丁目,722,688,653,1341
20190801,麻布地区総合支所管内,六本木五丁目,1208,1001,1138,2139
20190801,麻布地区総合支所管内,六本木六丁目,906,838,874,1712
20190801,麻布地区総合支所管内,六本木七丁目,1453,1078,1076,2154
20190801,麻布地区総合支所管内,麻布台一丁目,151,130,111,241
20190801,麻布地区総合支所管内,麻布台二丁目,303,260,254,514
20190801,麻布地区総合支所管内,麻布台三丁目,628,485,556,1041
20190801,麻布地区総合支所管内,麻布十番一丁目,798,601,674,1275
20190801,麻布地区総合支所管内,麻布十番二丁目,1959,1338,1504,2842
20190801,麻布地区総合支所管内,麻布十番三丁目,1268,869,928,1797
20190801,麻布地区総合支所管内,麻布十番四丁目,346,184,288,472
20190801,麻布地区総合支所管内,東麻布一丁目,1624,1075,1295,2370
20190801,麻布地区総合支所管内,東麻布二丁目,1468,1089,1177,2266
20190801,麻布地区総合支所管内,東麻布三丁目,613,405,457,862
20190801,赤坂地区総合支所管内,元赤坂一丁目,218,154,176,330
20190801,赤坂地区総合支所管内,元赤坂二丁目,175,180,142,322
20190801,赤坂地区総合支所管内,赤坂一丁目,300,301,341,642
20190801,赤坂地区総合支所管内,赤坂二丁目,2090,1542,1543,3085
20190801,赤坂地区総合支所管内,赤坂三丁目,195,142,124,266
20190801,赤坂地区総合支所管内,赤坂四丁目,1358,1131,1149,2280
20190801,赤坂地区総合支所管内,赤坂五丁目,530,404,497,901
20190801,赤坂地区総合支所管内,赤坂六丁目,2489,1923,2080,4003
20190801,赤坂地区総合支所管内,赤坂七丁目,1559,1227,1326,2553
20190801,赤坂地区総合支所管内,赤坂八丁目,1737,1455,1838,3293
20190801,赤坂地区総合支所管内,赤坂九丁目,1453,1154,1003,2157
20190801,赤坂地区総合支所管内,南青山一丁目,1439,1183,1396,2579
20190801,赤坂地区総合支所管内,南青山二丁目,1261,1099,1182,2281
20190801,赤坂地区総合支所管内,南青山三丁目,675,526,658,1184
20190801,赤坂地区総合支所管内,南青山四丁目,1702,1567,1824,3391
20190801,赤坂地区総合支所管内,南青山五丁目,725,645,764,1409
20190801,赤坂地区総合支所管内,南青山六丁目,1042,860,1008,1868
20190801,赤坂地区総合支所管内,南青山七丁目,1218,1111,1354,2465
20190801,赤坂地区総合支所管内,北青山一丁目,750,596,871,1467
20190801,赤坂地区総合支所管内,北青山二丁目,306,244,296,540
20190801,赤坂地区総合支所管内,北青山三丁目,375,262,364,626
20190801,高輪地区総合支所管内,三田四丁目,2013,1637,1982,3619
20190801,高輪地区総合支所管内,三田五丁目,3326,2638,3336,5974
20190801,高輪地区総合支所管内,高輪一丁目,3880,3077,3906,6983
20190801,高輪地区総合支所管内,高輪二丁目,3751,2988,3663,6651
20190801,高輪地区総合支所管内,高輪三丁目,2561,2212,2555,4767
20190801,高輪地区総合支所管内,高輪四丁目,2363,2081,2249,4330
20190801,高輪地区総合支所管内,白金一丁目,2584,1893,2464,4357
20190801,高輪地区総合支所管内,白金二丁目,1285,1174,1441,2615
20190801,高輪地区総合支所管内,白金三丁目,2381,1805,2197,4002
20190801,高輪地区総合支所管内,白金四丁目,806,700,870,1570
20190801,高輪地区総合支所管内,白金五丁目,1091,778,922,1700
20190801,高輪地区総合支所管内,白金六丁目,2015,1691,2096,3787
20190801,高輪地区総合支所管内,白金台一丁目,492,463,576,1039
20190801,高輪地区総合支所管内,白金台二丁目,1551,1279,1599,2878
20190801,高輪地区総合支所管内,白金台三丁目,1955,1741,2213,3954
20190801,高輪地区総合支所管内,白金台四丁目,1217,956,1188,2144
20190801,高輪地区総合支所管内,白金台五丁目,1056,810,1058,1868
20190801,芝浦港南地区総合支所管内,芝浦一丁目,1851,1685,1614,3299
20190801,芝浦港南地区総合支所管内,芝浦二丁目,2224,1718,1891,3609
20190801,芝浦港南地区総合支所管内,芝浦三丁目,1272,1000,1099,2099
20190801,芝浦港南地区総合支所管内,芝浦四丁目,8196,8257,8586,16843
20190801,芝浦港南地区総合支所管内,海岸二丁目,525,465,454,919
20190801,芝浦港南地区総合支所管内,海岸三丁目,2499,2037,1618,3655
20190801,芝浦港南地区総合支所管内,港南一丁目,208,163,166,329
20190801,芝浦港南地区総合支所管内,港南二丁目,1359,1277,1361,2638
20190801,芝浦港南地区総合支所管内,港南三丁目,3116,3146,3416,6562
20190801,芝浦港南地区総合支所管内,港南四丁目,5005,5134,5624,10758
20190801,芝浦港南地区総合支所管内,港南五丁目,320,306,226,532
20190801,芝浦港南地区総合支所管内,台場一丁目,2075,2249,2422,4671
20190801,芝浦港南地区総合支所管内,台場二丁目,459,477,482,959
20190901,芝地区総合支所管内,芝一丁目,1299,986,1049,2035
20190901,芝地区総合支所管内,芝二丁目,2292,1702,1922,3624
20190901,芝地区総合支所管内,芝三丁目,2259,1735,1906,3641
20190901,芝地区総合支所管内,芝四丁目,1412,1086,1203,2289
20190901,芝地区総合支所管内,芝五丁目,1957,1161,1647,2808
20190901,芝地区総合支所管内,海岸一丁目,1161,957,908,1865
20190901,芝地区総合支所管内,東新橋一丁目,769,658,772,1430
20190901,芝地区総合支所管内,東新橋二丁目,395,324,232,556
20190901,芝地区総合支所管内,新橋一丁目,10,5,8,13
20190901,芝地区総合支所管内,新橋二丁目,83,59,54,113
20190901,芝地区総合支所管内,新橋三丁目,127,118,101,219
20190901,芝地区総合支所管内,新橋四丁目,361,244,224,468
20190901,芝地区総合支所管内,新橋五丁目,659,440,403,843
20190901,芝地区総合支所管内,新橋六丁目,776,546,425,971
20190901,芝地区総合支所管内,西新橋一丁目,185,151,121,272
20190901,芝地区総合支所管内,西新橋二丁目,268,196,180,376
20190901,芝地区総合支所管内,西新橋三丁目,640,407,420,827
20190901,芝地区総合支所管内,三田一丁目,2395,1962,2284,4246
20190901,芝地区総合支所管内,三田二丁目,2352,1978,2414,4392
20190901,芝地区総合支所管内,三田三丁目,1072,802,862,1664
20190901,芝地区総合支所管内,浜松町一丁目,1222,1031,985,2016
20190901,芝地区総合支所管内,浜松町二丁目,219,168,133,301
20190901,芝地区総合支所管内,芝大門一丁目,411,315,326,641
20190901,芝地区総合支所管内,芝大門二丁目,584,405,414,819
20190901,芝地区総合支所管内,芝公園一丁目,167,118,121,239
20190901,芝地区総合支所管内,芝公園二丁目,448,328,330,658
20190901,芝地区総合支所管内,芝公園三丁目,164,153,163,316
20190901,芝地区総合支所管内,芝公園四丁目,49,34,28,62
20190901,芝地区総合支所管内,虎ノ門一丁目,278,217,225,442
20190901,芝地区総合支所管内,虎ノ門二丁目,10,8,6,14
20190901,芝地区総合支所管内,虎ノ門三丁目,1132,889,901,1790
20190901,芝地区総合支所管内,虎ノ門四丁目,380,194,382,576
20190901,芝地区総合支所管内,虎ノ門五丁目,174,160,173,333
20190901,芝地区総合支所管内,愛宕一丁目,20,24,21,45
20190901,芝地区総合支所管内,愛宕二丁目,281,265,259,524
20190901,麻布地区総合支所管内,麻布狸穴町,353,348,362,710
20190901,麻布地区総合支所管内,麻布永坂町,109,110,128,238
20190901,麻布地区総合支所管内,南麻布一丁目,2575,1963,2312,4275
20190901,麻布地区総合支所管内,南麻布二丁目,2552,1915,2185,4100
20190901,麻布地区総合支所管内,南麻布三丁目,1750,1478,1733,3211
20190901,麻布地区総合支所管内,南麻布四丁目,1904,1627,1940,3567
20190901,麻布地区総合支所管内,南麻布五丁目,1086,987,1210,2197
20190901,麻布地区総合支所管内,元麻布一丁目,577,550,648,1198
20190901,麻布地区総合支所管内,元麻布二丁目,1005,1025,1186,2211
20190901,麻布地区総合支所管内,元麻布三丁目,986,924,922,1846
20190901,麻布地区総合支所管内,西麻布一丁目,1167,859,834,1693
20190901,麻布地区総合支所管内,西麻布二丁目,1632,1310,1388,2698
20190901,麻布地区総合支所管内,西麻布三丁目,1816,1567,1795,3362
20190901,麻布地区総合支所管内,西麻布四丁目,1840,1544,1802,3346
20190901,麻布地区総合支所管内,六本木一丁目,1291,1166,1319,2485
20190901,麻布地区総合支所管内,六本木二丁目,615,374,354,728
20190901,麻布地区総合支所管内,六本木三丁目,1920,1473,1344,2817
20190901,麻布地区総合支所管内,六本木四丁目,728,695,649,1344
20190901,麻布地区総合支所管内,六本木五丁目,1216,1007,1151,2158
20190901,麻布地区総合支所管内,六本木六丁目,914,859,880,1739
20190901,麻布地区総合支所管内,六本木七丁目,1453,1070,1076,2146
20190901,麻布地区総合支所管内,麻布台一丁目,148,127,109,236
20190901,麻布地区総合支所管内,麻布台二丁目,304,259,252,511
20190901,麻布地区総合支所管内,麻布台三丁目,628,480,553,1033
20190901,麻布地区総合支所管内,麻布十番一丁目,795,601,670,1271
20190901,麻布地区総合支所管内,麻布十番二丁目,1962,1349,1502,2851
20190901,麻布地区総合支所管内,麻布十番三丁目,1267,868,932,1800
20190901,麻布地区総合支所管内,麻布十番四丁目,346,185,287,472
20190901,麻布地区総合支所管内,東麻布一丁目,1630,1081,1301,2382
20190901,麻布地区総合支所管内,東麻布二丁目,1473,1094,1182,2276
20190901,麻布地区総合支所管内,東麻布三丁目,617,412,458,870
20190901,赤坂地区総合支所管内,元赤坂一丁目,218,154,171,325
20190901,赤坂地区総合支所管内,元赤坂二丁目,173,179,141,320
20190901,赤坂地区総合支所管内,赤坂一丁目,295,295,343,638
20190901,赤坂地区総合支所管内,赤坂二丁目,2100,1543,1545,3088
20190901,赤坂地区総合支所管内,赤坂三丁目,197,142,126,268
20190901,赤坂地区総合支所管内,赤坂四丁目,1370,1140,1153,2293
20190901,赤坂地区総合支所管内,赤坂五丁目,526,397,491,888
20190901,赤坂地区総合支所管内,赤坂六丁目,2487,1936,2083,4019
20190901,赤坂地区総合支所管内,赤坂七丁目,1569,1232,1338,2570
20190901,赤坂地区総合支所管内,赤坂八丁目,1733,1456,1831,3287
20190901,赤坂地区総合支所管内,赤坂九丁目,1444,1146,1000,2146
20190901,赤坂地区総合支所管内,南青山一丁目,1437,1180,1400,2580
20190901,赤坂地区総合支所管内,南青山二丁目,1261,1096,1186,2282
20190901,赤坂地区総合支所管内,南青山三丁目,674,526,658,1184
20190901,赤坂地区総合支所管内,南青山四丁目,1703,1570,1816,3386
20190901,赤坂地区総合支所管内,南青山五丁目,728,647,772,1419
20190901,赤坂地区総合支所管内,南青山六丁目,1040,855,1000,1855
20190901,赤坂地区総合支所管内,南青山七丁目,1217,1106,1358,2464
20190901,赤坂地区総合支所管内,北青山一丁目,754,596,872,1468
20190901,赤坂地区総合支所管内,北青山二丁目,302,240,294,534
20190901,赤坂地区総合支所管内,北青山三丁目,371,260,362,622
20190901,高輪地区総合支所管内,三田四丁目,2011,1637,1983,3620
20190901,高輪地区総合支所管内,三田五丁目,3322,2640,3331,5971
20190901,高輪地区総合支所管内,高輪一丁目,3885,3083,3913,6996
20190901,高輪地区総合支所管内,高輪二丁目,3752,2991,3660,6651
20190901,高輪地区総合支所管内,高輪三丁目,2560,2205,2549,4754
20190901,高輪地区総合支所管内,高輪四丁目,2357,2085,2251,4336
20190901,高輪地区総合支所管内,白金一丁目,2588,1892,2468,4360
20190901,高輪地区総合支所管内,白金二丁目,1293,1176,1459,2635
20190901,高輪地区総合支所管内,白金三丁目,2375,1798,2193,3991
20190901,高輪地区総合支所管内,白金四丁目,807,703,872,1575
20190901,高輪地区総合支所管内,白金五丁目,1092,779,923,1702
20190901,高輪地区総合支所管内,白金六丁目,2020,1690,2104,3794
20190901,高輪地区総合支所管内,白金台一丁目,494,456,576,1032
20190901,高輪地区総合支所管内,白金台二丁目,1545,1284,1594,2878
20190901,高輪地区総合支所管内,白金台三丁目,1955,1741,2208,3949
20190901,高輪地区総合支所管内,白金台四丁目,1181,936,1172,2108
20190901,高輪地区総合支所管内,白金台五丁目,1059,818,1061,1879
20190901,芝浦港南地区総合支所管内,芝浦一丁目,1857,1693,1618,3311
20190901,芝浦港南地区総合支所管内,芝浦二丁目,2207,1708,1877,3585
20190901,芝浦港南地区総合支所管内,芝浦三丁目,1269,999,1098,2097
20190901,芝浦港南地区総合支所管内,芝浦四丁目,8223,8268,8613,16881
20190901,芝浦港南地区総合支所管内,海岸二丁目,528,469,453,922
20190901,芝浦港南地区総合支所管内,海岸三丁目,2515,2045,1626,3671
20190901,芝浦港南地区総合支所管内,港南一丁目,215,166,175,341
20190901,芝浦港南地区総合支所管内,港南二丁目,1352,1262,1358,2620
20190901,芝浦港南地区総合支所管内,港南三丁目,3120,3158,3424,6582
20190901,芝浦港南地区総合支所管内,港南四丁目,4982,5120,5606,10726
20190901,芝浦港南地区総合支所管内,港南五丁目,318,304,226,530
20190901,芝浦港南地区総合支所管内,台場一丁目,2064,2237,2415,4652
20190901,芝浦港南地区総合支所管内,台場二丁目,458,477,481,958
20191001,芝地区総合支所管内,芝一丁目,1317,1003,1061,2064
20191001,芝地区総合支所管内,芝二丁目,2286,1697,1920,3617
20191001,芝地区総合支所管内,芝三丁目,2256,1729,1907,3636
20191001,芝地区総合支所管内,芝四丁目,1419,1097,1206,2303
20191001,芝地区総合支所管内,芝五丁目,1967,1157,1656,2813
20191001,芝地区総合支所管内,海岸一丁目,1161,957,910,1867
20191001,芝地区総合支所管内,東新橋一丁目,770,664,772,1436
20191001,芝地区総合支所管内,東新橋二丁目,386,316,231,547
20191001,芝地区総合支所管内,新橋一丁目,10,5,8,13
20191001,芝地区総合支所管内,新橋二丁目,83,59,54,113
20191001,芝地区総合支所管内,新橋三丁目,125,117,100,217
20191001,芝地区総合支所管内,新橋四丁目,355,240,221,461
20191001,芝地区総合支所管内,新橋五丁目,655,438,398,836
20191001,芝地区総合支所管内,新橋六丁目,780,546,425,971
20191001,芝地区総合支所管内,西新橋一丁目,183,151,115,266
20191001,芝地区総合支所管内,西新橋二丁目,267,194,180,374
20191001,芝地区総合支所管内,西新橋三丁目,640,410,421,831
20191001,芝地区総合支所管内,三田一丁目,2392,1965,2277,4242
20191001,芝地区総合支所管内,三田二丁目,2363,1981,2423,4404
20191001,芝地区総合支所管内,三田三丁目,1068,800,859,1659
20191001,芝地区総合支所管内,浜松町一丁目,1263,1064,1015,2079
20191001,芝地区総合支所管内,浜松町二丁目,220,168,134,302
20191001,芝地区総合支所管内,芝大門一丁目,415,317,329,646
20191001,芝地区総合支所管内,芝大門二丁目,582,400,409,809
20191001,芝地区総合支所管内,芝公園一丁目,164,115,122,237
20191001,芝地区総合支所管内,芝公園二丁目,451,328,336,664
20191001,芝地区総合支所管内,芝公園三丁目,162,152,163,315
20191001,芝地区総合支所管内,芝公園四丁目,50,34,29,63
20191001,芝地区総合支所管内,虎ノ門一丁目,275,215,224,439
20191001,芝地区総合支所管内,虎ノ門二丁目,10,8,6,14
20191001,芝地区総合支所管内,虎ノ門三丁目,1129,884,894,1778
20191001,芝地区総合支所管内,虎ノ門四丁目,369,192,371,563
20191001,芝地区総合支所管内,虎ノ門五丁目,173,160,173,333
20191001,芝地区総合支所管内,愛宕一丁目,20,24,21,45
20191001,芝地区総合支所管内,愛宕二丁目,282,263,255,518
20191001,麻布地区総合支所管内,麻布狸穴町,353,349,359,708
20191001,麻布地区総合支所管内,麻布永坂町,110,111,129,240
20191001,麻布地区総合支所管内,南麻布一丁目,2586,1978,2322,4300
20191001,麻布地区総合支所管内,南麻布二丁目,2565,1923,2186,4109
20191001,麻布地区総合支所管内,南麻布三丁目,1740,1474,1721,3195
20191001,麻布地区総合支所管内,南麻布四丁目,1908,1634,1940,3574
20191001,麻布地区総合支所管内,南麻布五丁目,1085,979,1203,2182
20191001,麻布地区総合支所管内,元麻布一丁目,579,551,652,1203
20191001,麻布地区総合支所管内,元麻布二丁目,1002,1024,1189,2213
20191001,麻布地区総合支所管内,元麻布三丁目,982,929,928,1857
20191001,麻布地区総合支所管内,西麻布一丁目,1178,866,836,1702
20191001,麻布地区総合支所管内,西麻布二丁目,1640,1313,1393,2706
20191001,麻布地区総合支所管内,西麻布三丁目,1811,1564,1787,3351
20191001,麻布地区総合支所管内,西麻布四丁目,1835,1539,1810,3349
20191001,麻布地区総合支所管内,六本木一丁目,1292,1166,1319,2485
20191001,麻布地区総合支所管内,六本木二丁目,612,371,352,723
20191001,麻布地区総合支所管内,六本木三丁目,1932,1486,1350,2836
20191001,麻布地区総合支所管内,六本木四丁目,731,699,657,1356
20191001,麻布地区総合支所管内,六本木五丁目,1207,998,1145,2143
20191001,麻布地区総合支所管内,六本木六丁目,917,859,879,1738
20191001,麻布地区総合支所管内,六本木七丁目,1459,1075,1086,2161
20191001,麻布地区総合支所管内,麻布台一丁目,145,124,108,232
20191001,麻布地区総合支所管内,麻布台二丁目,303,257,255,512
20191001,麻布地区総合支所管内,麻布台三丁目,625,480,554,1034
20191001,麻布地区総合支所管内,麻布十番一丁目,787,597,666,1263
20191001,麻布地区総合支所管内,麻布十番二丁目,1960,1344,1500,2844
20191001,麻布地区総合支所管内,麻布十番三丁目,1263,862,935,1797
20191001,麻布地区総合支所管内,麻布十番四丁目,344,186,285,471
20191001,麻布地区総合支所管内,東麻布一丁目,1631,1088,1303,2391
20191001,麻布地区総合支所管内,東麻布二丁目,1466,1089,1172,2261
20191001,麻布地区総合支所管内,東麻布三丁目,617,416,453,869
20191001,赤坂地区総合支所管内,元赤坂一丁目,219,155,171,326
20191001,赤坂地区総合支所管内,元赤坂二丁目,172,177,142,319
20191001,赤坂地区総合支所管内,赤坂一丁目,292,293,342,635
20191001,赤坂地区総合支所管内,赤坂二丁目,2098,1546,1533,3079
20191001,赤坂地区総合支所管内,赤坂三丁目,196,143,125,268
20191001,赤坂地区総合支所管内,赤坂四丁目,1373,1139,1159,2298
20191001,赤坂地区総合支所管内,赤坂五丁目,523,393,494,887
20191001,赤坂地区総合支所管内,赤坂六丁目,2490,1953,2082,4035
20191001,赤坂地区総合支所管内,赤坂七丁目,1563,1228,1327,2555
20191001,赤坂地区総合支所管内,赤坂八丁目,1749,1473,1854,3327
20191001,赤坂地区総合支所管内,赤坂九丁目,1461,1158,1023,2181
20191001,赤坂地区総合支所管内,南青山一丁目,1435,1178,1398,2576
20191001,赤坂地区総合支所管内,南青山二丁目,1265,1095,1192,2287
20191001,赤坂地区総合支所管内,南青山三丁目,671,525,655,1180
20191001,赤坂地区総合支所管内,南青山四丁目,1707,1578,1815,3393
20191001,赤坂地区総合支所管内,南青山五丁目,730,645,771,1416
20191001,赤坂地区総合支所管内,南青山六丁目,1037,848,991,1839
20191001,赤坂地区総合支所管内,南青山七丁目,1225,1103,1359,2462
20191001,赤坂地区総合支所管内,北青山一丁目,754,598,871,1469
20191001,赤坂地区総合支所管内,北青山二丁目,302,240,293,533
20191001,赤坂地区総合支所管内,北青山三丁目,368,259,358,617
20191001,高輪地区総合支所管内,三田四丁目,2008,1636,1973,3609
20191001,高輪地区総合支所管内,三田五丁目,3311,2647,3327,5974
20191001,高輪地区総合支所管内,高輪一丁目,3892,3086,3908,6994
20191001,高輪地区総合支所管内,高輪二丁目,3737,2981,3648,6629
20191001,高輪地区総合支所管内,高輪三丁目,2551,2198,2544,4742
20191001,高輪地区総合支所管内,高輪四丁目,2355,2079,2249,4328
20191001,高輪地区総合支所管内,白金一丁目,2592,1897,2480,4377
20191001,高輪地区総合支所管内,白金二丁目,1294,1177,1457,2634
20191001,高輪地区総合支所管内,白金三丁目,2367,1799,2196,3995
20191001,高輪地区総合支所管内,白金四丁目,804,706,873,1579
20191001,高輪地区総合支所管内,白金五丁目,1091,780,921,1701
20191001,高輪地区総合支所管内,白金六丁目,2017,1690,2107,3797
20191001,高輪地区総合支所管内,白金台一丁目,494,457,573,1030
20191001,高輪地区総合支所管内,白金台二丁目,1550,1286,1594,2880
20191001,高輪地区総合支所管内,白金台三丁目,1955,1743,2202,3945
20191001,高輪地区総合支所管内,白金台四丁目,1217,956,1198,2154
20191001,高輪地区総合支所管内,白金台五丁目,1058,817,1060,1877
20191001,芝浦港南地区総合支所管内,芝浦一丁目,1862,1693,1629,3322
20191001,芝浦港南地区総合支所管内,芝浦二丁目,2210,1715,1871,3586
20191001,芝浦港南地区総合支所管内,芝浦三丁目,1273,1006,1102,2108
20191001,芝浦港南地区総合支所管内,芝浦四丁目,8232,8278,8602,16880
20191001,芝浦港南地区総合支所管内,海岸二丁目,531,468,456,924
20191001,芝浦港南地区総合支所管内,海岸三丁目,2514,2048,1629,3677
20191001,芝浦港南地区総合支所管内,港南一丁目,217,168,177,345
20191001,芝浦港南地区総合支所管内,港南二丁目,1349,1255,1350,2605
20191001,芝浦港南地区総合支所管内,港南三丁目,3114,3166,3422,6588
20191001,芝浦港南地区総合支所管内,港南四丁目,4979,5118,5609,10727
20191001,芝浦港南地区総合支所管内,港南五丁目,318,304,223,527
20191001,芝浦港南地区総合支所管内,台場一丁目,2065,2243,2417,4660
20191001,芝浦港南地区総合支所管内,台場二丁目,457,478,481,959
20191101,芝地区総合支所管内,芝一丁目,1311,1001,1058,2059
20191101,芝地区総合支所管内,芝二丁目,2300,1715,1922,3637
20191101,芝地区総合支所管内,芝三丁目,2245,1719,1906,3625
20191101,芝地区総合支所管内,芝四丁目,1425,1103,1212,2315
20191101,芝地区総合支所管内,芝五丁目,1960,1148,1654,2802
20191101,芝地区総合支所管内,海岸一丁目,1162,963,915,1878
20191101,芝地区総合支所管内,東新橋一丁目,769,663,775,1438
20191101,芝地区総合支所管内,東新橋二丁目,419,347,233,580
20191101,芝地区総合支所管内,新橋一丁目,10,5,8,13
20191101,芝地区総合支所管内,新橋二丁目,80,58,52,110
20191101,芝地区総合支所管内,新橋三丁目,131,122,101,223
20191101,芝地区総合支所管内,新橋四丁目,358,246,219,465
20191101,芝地区総合支所管内,新橋五丁目,653,438,395,833
20191101,芝地区総合支所管内,新橋六丁目,786,552,425,977
20191101,芝地区総合支所管内,西新橋一丁目,182,150,115,265
20191101,芝地区総合支所管内,西新橋二丁目,272,194,184,378
20191101,芝地区総合支所管内,西新橋三丁目,639,415,418,833
20191101,芝地区総合支所管内,三田一丁目,2385,1968,2272,4240
20191101,芝地区総合支所管内,三田二丁目,2365,1987,2420,4407
20191101,芝地区総合支所管内,三田三丁目,1070,801,858,1659
20191101,芝地区総合支所管内,浜松町一丁目,1275,1071,1028,2099
20191101,芝地区総合支所管内,浜松町二丁目,218,169,131,300
20191101,芝地区総合支所管内,芝大門一丁目,416,317,332,649
20191101,芝地区総合支所管内,芝大門二丁目,589,402,414,816
20191101,芝地区総合支所管内,芝公園一丁目,165,115,124,239
20191101,芝地区総合支所管内,芝公園二丁目,452,325,340,665
20191101,芝地区総合支所管内,芝公園三丁目,163,151,165,316
20191101,芝地区総合支所管内,芝公園四丁目,52,34,31,65
20191101,芝地区総合支所管内,虎ノ門一丁目,274,214,224,438
20191101,芝地区総合支所管内,虎ノ門二丁目,10,8,6,14
20191101,芝地区総合支所管内,虎ノ門三丁目,1120,877,894,1771
20191101,芝地区総合支所管内,虎ノ門四丁目,365,192,366,558
20191101,芝地区総合支所管内,虎ノ門五丁目,175,161,172,333
20191101,芝地区総合支所管内,愛宕一丁目,20,24,21,45
20191101,芝地区総合支所管内,愛宕二丁目,282,261,255,516
20191101,麻布地区総合支所管内,麻布狸穴町,348,341,356,697
20191101,麻布地区総合支所管内,麻布永坂町,111,111,130,241
20191101,麻布地区総合支所管内,南麻布一丁目,2601,2001,2342,4343
20191101,麻布地区総合支所管内,南麻布二丁目,2555,1916,2172,4088
20191101,麻布地区総合支所管内,南麻布三丁目,1739,1474,1718,3192
20191101,麻布地区総合支所管内,南麻布四丁目,1916,1638,1941,3579
20191101,麻布地区総合支所管内,南麻布五丁目,1078,972,1195,2167
20191101,麻布地区総合支所管内,元麻布一丁目,577,549,656,1205
20191101,麻布地区総合支所管内,元麻布二丁目,1001,1026,1182,2208
20191101,麻布地区総合支所管内,元麻布三丁目,991,939,920,1859
20191101,麻布地区総合支所管内,西麻布一丁目,1180,871,842,1713
20191101,麻布地区総合支所管内,西麻布二丁目,1644,1321,1387,2708
20191101,麻布地区総合支所管内,西麻布三丁目,1804,1567,1780,3347
20191101,麻布地区総合支所管内,西麻布四丁目,1850,1552,1820,3372
20191101,麻布地区総合支所管内,六本木一丁目,1284,1158,1311,2469
20191101,麻布地区総合支所管内,六本木二丁目,614,372,353,725
20191101,麻布地区総合支所管内,六本木三丁目,1909,1458,1344,2802
20191101,麻布地区総合支所管内,六本木四丁目,740,710,659,1369
20191101,麻布地区総合支所管内,六本木五丁目,1203,994,1141,2135
20191101,麻布地区総合支所管内,六本木六丁目,920,867,886,1753
20191101,麻布地区総合支所管内,六本木七丁目,1463,1082,1087,2169
20191101,麻布地区総合支所管内,麻布台一丁目,142,122,107,229
20191101,麻布地区総合支所管内,麻布台二丁目,305,258,257,515
20191101,麻布地区総合支所管内,麻布台三丁目,624,476,552,1028
20191101,麻布地区総合支所管内,麻布十番一丁目,778,598,655,1253
20191101,麻布地区総合支所管内,麻布十番二丁目,1967,1354,1504,2858
20191101,麻布地区総合支所管内,麻布十番三丁目,1262,862,932,1794
20191101,麻布地区総合支所管内,麻布十番四丁目,346,188,284,472
20191101,麻布地区総合支所管内,東麻布一丁目,1648,1103,1310,2413
20191101,麻布地区総合支所管内,東麻布二丁目,1483,1100,1182,2282
20191101,麻布地区総合支所管内,東麻布三丁目,607,412,449,861
20191101,赤坂地区総合支所管内,元赤坂一丁目,231,163,180,343
20191101,赤坂地区総合支所管内,元赤坂二丁目,169,174,140,314
20191101,赤坂地区総合支所管内,赤坂一丁目,296,298,343,641
20191101,赤坂地区総合支所管内,赤坂二丁目,2120,1557,1537,3094
20191101,赤坂地区総合支所管内,赤坂三丁目,199,142,128,270
20191101,赤坂地区総合支所管内,赤坂四丁目,1388,1157,1172,2329
20191101,赤坂地区総合支所管内,赤坂五丁目,526,389,498,887
20191101,赤坂地区総合支所管内,赤坂六丁目,2483,1948,2081,4029
20191101,赤坂地区総合支所管内,赤坂七丁目,1562,1222,1334,2556
20191101,赤坂地区総合支所管内,赤坂八丁目,1758,1481,1862,3343
20191101,赤坂地区総合支所管内,赤坂九丁目,1466,1162,1022,2184
20191101,赤坂地区総合支所管内,南青山一丁目,1444,1184,1403,2587
20191101,赤坂地区総合支所管内,南青山二丁目,1263,1095,1194,2289
20191101,赤坂地区総合支所管内,南青山三丁目,674,525,659,1184
20191101,赤坂地区総合支所管内,南青山四丁目,1704,1571,1810,3381
20191101,赤坂地区総合支所管内,南青山五丁目,728,646,771,1417
20191101,赤坂地区総合支所管内,南青山六丁目,1038,847,994,1841
20191101,赤坂地区総合支所管内,南青山七丁目,1224,1105,1356,2461
20191101,赤坂地区総合支所管内,北青山一丁目,755,597,872,1469
20191101,赤坂地区総合支所管内,北青山二丁目,301,240,291,531
20191101,赤坂地区総合支所管内,北青山三丁目,363,259,351,610
20191101,高輪地区総合支所管内,三田四丁目,2011,1637,1974,3611
20191101,高輪地区総合支所管内,三田五丁目,3317,2652,3352,6004
20191101,高輪地区総合支所管内,高輪一丁目,3902,3084,3930,7014
20191101,高輪地区総合支所管内,高輪二丁目,3717,2961,3637,6598
20191101,高輪地区総合支所管内,高輪三丁目,2553,2195,2549,4744
20191101,高輪地区総合支所管内,高輪四丁目,2350,2078,2247,4325
20191101,高輪地区総合支所管内,白金一丁目,2579,1889,2460,4349
20191101,高輪地区総合支所管内,白金二丁目,1303,1187,1463,2650
20191101,高輪地区総合支所管内,白金三丁目,2364,1790,2200,3990
20191101,高輪地区総合支所管内,白金四丁目,804,705,873,1578
20191101,高輪地区総合支所管内,白金五丁目,1089,777,926,1703
20191101,高輪地区総合支所管内,白金六丁目,2019,1693,2110,3803
20191101,高輪地区総合支所管内,白金台一丁目,492,454,569,1023
20191101,高輪地区総合支所管内,白金台二丁目,1544,1281,1579,2860
20191101,高輪地区総合支所管内,白金台三丁目,1961,1761,2200,3961
20191101,高輪地区総合支所管内,白金台四丁目,1216,942,1196,2138
20191101,高輪地区総合支所管内,白金台五丁目,1051,818,1050,1868
20191101,芝浦港南地区総合支所管内,芝浦一丁目,1864,1702,1631,3333
20191101,芝浦港南地区総合支所管内,芝浦二丁目,2214,1721,1873,3594
20191101,芝浦港南地区総合支所管内,芝浦三丁目,1273,998,1107,2105
20191101,芝浦港南地区総合支所管内,芝浦四丁目,8264,8312,8624,16936
20191101,芝浦港南地区総合支所管内,海岸二丁目,533,468,461,929
20191101,芝浦港南地区総合支所管内,海岸三丁目,2510,2045,1623,3668
20191101,芝浦港南地区総合支所管内,港南一丁目,215,169,179,348
20191101,芝浦港南地区総合支所管内,港南二丁目,1381,1284,1368,2652
20191101,芝浦港南地区総合支所管内,港南三丁目,3121,3164,3428,6592
20191101,芝浦港南地区総合支所管内,港南四丁目,5009,5153,5629,10782
20191101,芝浦港南地区総合支所管内,港南五丁目,316,305,220,525
20191101,芝浦港南地区総合支所管内,台場一丁目,2062,2244,2416,4660
20191101,芝浦港南地区総合支所管内,台場二丁目,456,476,479,955
20191201,芝地区総合支所管内,芝一丁目,1319,1003,1061,2064
20191201,芝地区総合支所管内,芝二丁目,2297,1711,1916,3627
20191201,芝地区総合支所管内,芝三丁目,2240,1718,1911,3629
20191201,芝地区総合支所管内,芝四丁目,1423,1110,1210,2320
20191201,芝地区総合支所管内,芝五丁目,1965,1156,1653,2809
20191201,芝地区総合支所管内,海岸一丁目,1153,958,914,1872
20191201,芝地区総合支所管内,東新橋一丁目,767,659,772,1431
20191201,芝地区総合支所管内,東新橋二丁目,420,349,234,583
20191201,芝地区総合支所管内,新橋一丁目,10,5,8,13
20191201,芝地区総合支所管内,新橋二丁目,77,55,52,107
20191201,芝地区総合支所管内,新橋三丁目,130,120,101,221
20191201,芝地区総合支所管内,新橋四丁目,359,247,219,466
20191201,芝地区総合支所管内,新橋五丁目,662,445,398,843
20191201,芝地区総合支所管内,新橋六丁目,792,554,430,984
20191201,芝地区総合支所管内,西新橋一丁目,182,151,117,268
20191201,芝地区総合支所管内,西新橋二丁目,271,193,184,377
20191201,芝地区総合支所管内,西新橋三丁目,631,408,416,824
20191201,芝地区総合支所管内,三田一丁目,2401,1977,2273,4250
20191201,芝地区総合支所管内,三田二丁目,2369,1987,2429,4416
20191201,芝地区総合支所管内,三田三丁目,1075,805,859,1664
20191201,芝地区総合支所管内,浜松町一丁目,1289,1093,1034,2127
20191201,芝地区総合支所管内,浜松町二丁目,215,167,130,297
20191201,芝地区総合支所管内,芝大門一丁目,414,314,329,643
20191201,芝地区総合支所管内,芝大門二丁目,588,401,413,814
20191201,芝地区総合支所管内,芝公園一丁目,163,114,123,237
20191201,芝地区総合支所管内,芝公園二丁目,450,322,336,658
20191201,芝地区総合支所管内,芝公園三丁目,161,149,164,313
20191201,芝地区総合支所管内,芝公園四丁目,53,35,30,65
20191201,芝地区総合支所管内,虎ノ門一丁目,266,210,221,431
20191201,芝地区総合支所管内,虎ノ門二丁目,10,8,6,14
20191201,芝地区総合支所管内,虎ノ門三丁目,1118,876,902,1778
20191201,芝地区総合支所管内,虎ノ門四丁目,366,198,364,562
20191201,芝地区総合支所管内,虎ノ門五丁目,176,162,169,331
20191201,芝地区総合支所管内,愛宕一丁目,20,24,21,45
20191201,芝地区総合支所管内,愛宕二丁目,277,258,254,512
20191201,麻布地区総合支所管内,麻布狸穴町,351,343,360,703
20191201,麻布地区総合支所管内,麻布永坂町,113,112,132,244
20191201,麻布地区総合支所管内,南麻布一丁目,2607,2004,2346,4350
20191201,麻布地区総合支所管内,南麻布二丁目,2554,1914,2178,4092
20191201,麻布地区総合支所管内,南麻布三丁目,1732,1467,1710,3177
20191201,麻布地区総合支所管内,南麻布四丁目,1922,1650,1945,3595
20191201,麻布地区総合支所管内,南麻布五丁目,1076,965,1196,2161
20191201,麻布地区総合支所管内,元麻布一丁目,581,551,665,1216
20191201,麻布地区総合支所管内,元麻布二丁目,1002,1034,1181,2215
20191201,麻布地区総合支所管内,元麻布三丁目,995,948,922,1870
20191201,麻布地区総合支所管内,西麻布一丁目,1181,867,851,1718
20191201,麻布地区総合支所管内,西麻布二丁目,1648,1319,1391,2710
20191201,麻布地区総合支所管内,西麻布三丁目,1805,1573,1780,3353
20191201,麻布地区総合支所管内,西麻布四丁目,1852,1554,1817,3371
20191201,麻布地区総合支所管内,六本木一丁目,1281,1154,1305,2459
20191201,麻布地区総合支所管内,六本木二丁目,611,369,354,723
20191201,麻布地区総合支所管内,六本木三丁目,1909,1462,1346,2808
20191201,麻布地区総合支所管内,六本木四丁目,744,714,659,1373
20191201,麻布地区総合支所管内,六本木五丁目,1198,985,1137,2122
20191201,麻布地区総合支所管内,六本木六丁目,915,865,882,1747
20191201,麻布地区総合支所管内,六本木七丁目,1457,1079,1087,2166
20191201,麻布地区総合支所管内,麻布台一丁目,141,118,105,223
20191201,麻布地区総合支所管内,麻布台二丁目,303,257,257,514
20191201,麻布地区総合支所管内,麻布台三丁目,622,476,551,1027
20191201,麻布地区総合支所管内,麻布十番一丁目,764,594,640,1234
20191201,麻布地区総合支所管内,麻布十番二丁目,1967,1359,1508,2867
20191201,麻布地区総合支所管内,麻布十番三丁目,1260,863,928,1791
20191201,麻布地区総合支所管内,麻布十番四丁目,349,190,285,475
20191201,麻布地区総合支所管内,東麻布一丁目,1651,1107,1312,2419
20191201,麻布地区総合支所管内,東麻布二丁目,1483,1095,1185,2280
20191201,麻布地区総合支所管内,東麻布三丁目,601,409,445,854
20191201,赤坂地区総合支所管内,元赤坂一丁目,231,164,181,345
20191201,赤坂地区総合支所管内,元赤坂二丁目,169,175,140,315
20191201,赤坂地区総合支所管内,赤坂一丁目,299,306,349,655
20191201,赤坂地区総合支所管内,赤坂二丁目,2125,1565,1549,3114
20191201,赤坂地区総合支所管内,赤坂三丁目,203,148,126,274
20191201,赤坂地区総合支所管内,赤坂四丁目,1401,1168,1170,2338
20191201,赤坂地区総合支所管内,赤坂五丁目,522,387,494,881
20191201,赤坂地区総合支所管内,赤坂六丁目,2486,1944,2089,4033
20191201,赤坂地区総合支所管内,赤坂七丁目,1559,1222,1329,2551
20191201,赤坂地区総合支所管内,赤坂八丁目,1753,1480,1854,3334
20191201,赤坂地区総合支所管内,赤坂九丁目,1460,1158,1024,2182
20191201,赤坂地区総合支所管内,南青山一丁目,1451,1190,1412,2602
20191201,赤坂地区総合支所管内,南青山二丁目,1263,1091,1191,2282
20191201,赤坂地区総合支所管内,南青山三丁目,673,527,659,1186
20191201,赤坂地区総合支所管内,南青山四丁目,1707,1571,1818,3389
20191201,赤坂地区総合支所管内,南青山五丁目,729,645,767,1412
20191201,赤坂地区総合支所管内,南青山六丁目,1046,849,1006,1855
20191201,赤坂地区総合支所管内,南青山七丁目,1232,1108,1362,2470
20191201,赤坂地区総合支所管内,北青山一丁目,752,591,874,1465
20191201,赤坂地区総合支所管内,北青山二丁目,302,239,292,531
20191201,赤坂地区総合支所管内,北青山三丁目,353,255,341,596
20191201,高輪地区総合支所管内,三田四丁目,2016,1641,1980,3621
20191201,高輪地区総合支所管内,三田五丁目,3330,2660,3364,6024
20191201,高輪地区総合支所管内,高輪一丁目,3890,3081,3922,7003
20191201,高輪地区総合支所管内,高輪二丁目,3698,2947,3614,6561
20191201,高輪地区総合支所管内,高輪三丁目,2547,2193,2551,4744
20191201,高輪地区総合支所管内,高輪四丁目,2337,2077,2248,4325
20191201,高輪地区総合支所管内,白金一丁目,2548,1866,2441,4307
20191201,高輪地区総合支所管内,白金二丁目,1304,1192,1459,2651
20191201,高輪地区総合支所管内,白金三丁目,2360,1793,2196,3989
20191201,高輪地区総合支所管内,白金四丁目,801,705,869,1574
20191201,高輪地区総合支所管内,白金五丁目,1088,771,932,1703
20191201,高輪地区総合支所管内,白金六丁目,2014,1692,2093,3785
20191201,高輪地区総合支所管内,白金台一丁目,493,455,570,1025
20191201,高輪地区総合支所管内,白金台二丁目,1545,1291,1579,2870
20191201,高輪地区総合支所管内,白金台三丁目,1960,1766,2202,3968
20191201,高輪地区総合支所管内,白金台四丁目,1214,938,1191,2129
20191201,高輪地区総合支所管内,白金台五丁目,1053,818,1052,1870
20191201,芝浦港南地区総合支所管内,芝浦一丁目,1864,1705,1635,3340
20191201,芝浦港南地区総合支所管内,芝浦二丁目,2215,1728,1876,3604
20191201,芝浦港南地区総合支所管内,芝浦三丁目,1276,997,1112,2109
20191201,芝浦港南地区総合支所管内,芝浦四丁目,8272,8324,8649,16973
20191201,芝浦港南地区総合支所管内,海岸二丁目,529,468,462,930
20191201,芝浦港南地区総合支所管内,海岸三丁目,2523,2047,1651,3698
20191201,芝浦港南地区総合支所管内,港南一丁目,216,170,182,352
20191201,芝浦港南地区総合支所管内,港南二丁目,1382,1280,1367,2647
20191201,芝浦港南地区総合支所管内,港南三丁目,3129,3161,3444,6605
20191201,芝浦港南地区総合支所管内,港南四丁目,5010,5156,5645,10801
20191201,芝浦港南地区総合支所管内,港南五丁目,317,304,219,523
20191201,芝浦港南地区総合支所管内,台場一丁目,2077,2258,2437,4695
20191201,芝浦港南地区総合支所管内,台場二丁目,457,477,481,958

町丁目別人口・世帯数 2019年,Ver201912
